state_ut,crime_head,persons_in_custody_or_on_bail_during_the_stage_of_investigation_at_the_beginning_of_the_year,persons_arrested_during_the_year,persons_released_or_freed_by_police_or_magistrate_before_trial_for_want_of_evidence_or_any_other_reason,persons_in_custody_or_on_bail_during_the_stage_of_investigation_at_the_end_of_the_year,persons_in_whose_cases_charge_sheets_were_laid_during_the_year,persons_under_trial_at_the_beginning_of_the_year,total_number_of_persons_under_trial_during_the_year,persons_against_whom_cases_were_compounded_or_withdrawn,persons_in_custody_or_on_bail_during_the_stage_of_trial_at_the_end_of_the_year,persons_in_whose_cases_trials_were_completed_during_the_year,persons_convicted,persons_acquitted
ANDHRA PRADESH,MURDER (SECTION 302 IPC),3263,5509,0,3138,5634,12111,17745,2,13142,4601,754,3847
ARUNACHAL PRADESH,MURDER (SECTION 302 IPC),85,113,28,109,61,1108,1169,0,1161,8,2,6
ASSAM,MURDER (SECTION 302 IPC),4628,1650,466,4756,1056,8040,9096,0,8183,913,308,605
BIHAR,MURDER (SECTION 302 IPC),7459,7198,51,7399,7207,52966,60173,0,54985,5188,1450,3738
CHHATTISGARH,MURDER (SECTION 302 IPC),188,1490,0,158,1520,7803,9323,1221,6661,1441,590,851
GOA,MURDER (SECTION 302 IPC),29,47,2,24,50,197,247,0,230,17,9,8
GUJARAT,MURDER (SECTION 302 IPC),353,2085,2,312,2124,26816,28940,5,27873,1062,211,851
HARYANA,MURDER (SECTION 302 IPC),311,2183,0,233,2261,5418,7679,0,5548,2131,868,1263
HIMACHAL PRADESH,MURDER (SECTION 302 IPC),65,206,10,70,191,715,906,0,744,162,65,97
JAMMU & KASHMIR,MURDER (SECTION 302 IPC),22,328,0,25,325,4063,4388,0,4000,388,78,310
JHARKHAND,MURDER (SECTION 302 IPC),1242,1790,0,1274,1758,4027,5785,8,3964,1813,474,1339
KARNATAKA,MURDER (SECTION 302 IPC),722,3487,95,598,3516,10784,14300,17,11455,2828,470,2358
KERALA,MURDER (SECTION 302 IPC),993,886,16,866,997,7005,8002,4,7476,522,148,374
MADHYA PRADESH,MURDER (SECTION 302 IPC),240,5505,0,227,5518,21360,26878,2,22407,4469,1920,2549
MAHARASHTRA,MURDER (SECTION 302 IPC),1633,6119,75,1778,5899,65330,71229,2,67005,4222,944,3278
MANIPUR,MURDER (SECTION 302 IPC),222,49,52,206,13,429,442,2,437,3,2,1
MEGHALAYA,MURDER (SECTION 302 IPC),414,97,17,433,61,2175,2236,0,2220,16,5,11
MIZORAM,MURDER (SECTION 302 IPC),17,26,0,23,20,44,64,0,41,23,23,0
NAGALAND,MURDER (SECTION 302 IPC),14,31,6,12,27,42,69,3,35,31,23,8
ODISHA,MURDER (SECTION 302 IPC),359,2450,8,392,2409,11588,13997,0,12473,1524,337,1187
PUNJAB,MURDER (SECTION 302 IPC),1209,1553,73,1373,1316,2687,4003,0,2791,1212,596,616
RAJASTHAN,MURDER (SECTION 302 IPC),71,2175,0,64,2182,14017,16199,1043,13539,1617,772,845
SIKKIM,MURDER (SECTION 302 IPC),4,7,0,6,5,97,102,0,67,35,24,11
TAMIL NADU,MURDER (SECTION 302 IPC),2271,4420,45,2231,4415,10057,14472,3,11578,2891,1032,1859
TRIPURA,MURDER (SECTION 302 IPC),102,167,34,84,151,292,443,0,318,125,46,79
UTTAR PRADESH,MURDER (SECTION 302 IPC),2220,13983,2381,2695,11127,70108,81235,111,73091,8033,3891,4142
UTTARAKHAND,MURDER (SECTION 302 IPC),78,347,24,52,349,2429,2778,0,2219,559,376,183
WEST BENGAL,MURDER (SECTION 302 IPC),4566,3534,184,4575,3341,27845,31186,62,28689,2435,592,1843
TOTAL (STATES),MURDER (SECTION 302 IPC),32780,67435,3569,33113,63533,369553,433086,2485,382332,48269,16010,32259
A & N ISLANDS,MURDER (SECTION 302 IPC),20,21,0,11,30,244,274,0,271,3,3,0
CHANDIGARH,MURDER (SECTION 302 IPC),16,66,0,17,65,111,176,0,124,52,22,30
D & N HAVELI,MURDER (SECTION 302 IPC),15,13,0,6,22,50,72,0,70,2,0,2
DAMAN & DIU,MURDER (SECTION 302 IPC),1,11,0,1,11,72,83,0,49,34,8,26
DELHI,MURDER (SECTION 302 IPC),544,987,10,478,1043,5730,6773,0,6006,767,394,373
LAKSHADWEEP,MURDER (SECTION 302 IPC),0,0,0,0,0,0,0,0,0,0,0,0
PUDUCHERRY,MURDER (SECTION 302 IPC),57,143,0,54,146,726,872,0,830,42,1,41
TOTAL (UTs),MURDER (SECTION 302 IPC),653,1241,10,567,1317,6933,8250,0,7350,900,428,472
TOTAL (ALL-INDIA),MURDER (SECTION 302 IPC),33433,68676,3579,33680,64850,376486,441336,2485,389682,49169,16438,32731
ANDHRA PRADESH,ATTEMPT TO COMMIT MURDER (SECTION 307 IPC),2030,4836,0,2124,4742,6838,11580,62,8490,3028,547,2481
ARUNACHAL PRADESH,ATTEMPT TO COMMIT MURDER (SECTION 307 IPC),38,30,5,44,19,546,565,0,563,2,1,1
ASSAM,ATTEMPT TO COMMIT MURDER (SECTION 307 IPC),791,779,199,918,453,1888,2341,0,2061,280,35,245
BIHAR,ATTEMPT TO COMMIT MURDER (SECTION 307 IPC),4721,12480,140,5856,11205,53209,64414,0,58669,5745,668,5077
CHHATTISGARH,ATTEMPT TO COMMIT MURDER (SECTION 307 IPC),140,1004,0,104,1040,6571,7611,46,6290,1275,412,863
GOA,ATTEMPT TO COMMIT MURDER (SECTION 307 IPC),94,102,0,169,27,278,305,0,288,17,3,14
GUJARAT,ATTEMPT TO COMMIT MURDER (SECTION 307 IPC),304,2676,3,271,2706,31016,33722,5,33007,710,43,667
HARYANA,ATTEMPT TO COMMIT MURDER (SECTION 307 IPC),234,2311,0,202,2343,5129,7472,7,5677,1788,389,1399
HIMACHAL PRADESH,ATTEMPT TO COMMIT MURDER (SECTION 307 IPC),28,109,0,44,93,1041,1134,14,921,199,30,169
JAMMU & KASHMIR,ATTEMPT TO COMMIT MURDER (SECTION 307 IPC),36,1134,0,39,1131,10560,11691,89,10638,964,43,921
JHARKHAND,ATTEMPT TO COMMIT MURDER (SECTION 307 IPC),1216,1452,0,1150,1518,3367,4885,12,3539,1334,359,975
KARNATAKA,ATTEMPT TO COMMIT MURDER (SECTION 307 IPC),1009,4939,70,1144,4734,13791,18525,6,14244,4275,248,4027
KERALA,ATTEMPT TO COMMIT MURDER (SECTION 307 IPC),1215,1716,0,1386,1545,17366,18911,19,18095,797,141,656
MADHYA PRADESH,ATTEMPT TO COMMIT MURDER (SECTION 307 IPC),232,6702,0,246,6688,32789,39477,6,34033,5438,1643,3795
MAHARASHTRA,ATTEMPT TO COMMIT MURDER (SECTION 307 IPC),3162,7771,31,3488,7414,71312,78726,110,74811,3805,446,3359
MANIPUR,ATTEMPT TO COMMIT MURDER (SECTION 307 IPC),212,111,109,209,5,70,75,0,72,3,2,1
MEGHALAYA,ATTEMPT TO COMMIT MURDER (SECTION 307 IPC),162,37,1,175,23,182,205,0,202,3,0,3
MIZORAM,ATTEMPT TO COMMIT MURDER (SECTION 307 IPC),4,14,0,6,12,31,43,0,21,22,18,4
NAGALAND,ATTEMPT TO COMMIT MURDER (SECTION 307 IPC),24,42,6,8,52,39,91,4,32,55,47,8
ODISHA,ATTEMPT TO COMMIT MURDER (SECTION 307 IPC),437,3343,12,524,3244,13869,17113,0,15003,2110,357,1753
PUNJAB,ATTEMPT TO COMMIT MURDER (SECTION 307 IPC),2132,2298,109,2413,1908,5427,7335,0,5715,1620,577,1043
RAJASTHAN,ATTEMPT TO COMMIT MURDER (SECTION 307 IPC),80,3607,1,55,3631,21396,25027,333,22042,2652,1247,1405
SIKKIM,ATTEMPT TO COMMIT MURDER (SECTION 307 IPC),3,8,0,7,4,28,32,0,22,10,6,4
TAMIL NADU,ATTEMPT TO COMMIT MURDER (SECTION 307 IPC),6412,6753,31,5984,7150,17348,24498,0,19508,4990,1274,3716
TRIPURA,ATTEMPT TO COMMIT MURDER (SECTION 307 IPC),29,84,5,28,80,117,197,0,141,56,7,49
UTTAR PRADESH,ATTEMPT TO COMMIT MURDER (SECTION 307 IPC),1782,13116,2526,2038,10334,45263,55597,142,48295,7160,3143,4017
UTTARAKHAND,ATTEMPT TO COMMIT MURDER (SECTION 307 IPC),64,293,9,65,283,1995,2278,6,1621,651,369,282
WEST BENGAL,ATTEMPT TO COMMIT MURDER (SECTION 307 IPC),1198,3702,153,1252,3495,7143,10638,2,9546,1090,58,1032
TOTAL (STATES),ATTEMPT TO COMMIT MURDER (SECTION 307 IPC),27789,81449,3410,29949,75879,368609,444488,863,393546,50079,12113,37966
A & N ISLANDS,ATTEMPT TO COMMIT MURDER (SECTION 307 IPC),18,9,0,17,10,137,147,0,142,5,2,3
CHANDIGARH,ATTEMPT TO COMMIT MURDER (SECTION 307 IPC),64,118,7,26,149,241,390,0,302,88,25,63
D & N HAVELI,ATTEMPT TO COMMIT MURDER (SECTION 307 IPC),6,3,0,6,3,43,46,0,34,12,0,12
DAMAN & DIU,ATTEMPT TO COMMIT MURDER (SECTION 307 IPC),0,7,0,1,6,44,50,0,34,16,0,16
DELHI,ATTEMPT TO COMMIT MURDER (SECTION 307 IPC),826,950,7,863,906,8927,9833,0,9000,833,438,395
LAKSHADWEEP,ATTEMPT TO COMMIT MURDER (SECTION 307 IPC),22,0,0,22,0,0,0,0,0,0,0,0
PUDUCHERRY,ATTEMPT TO COMMIT MURDER (SECTION 307 IPC),31,133,0,96,68,605,673,0,653,20,8,12
TOTAL (UTs),ATTEMPT TO COMMIT MURDER (SECTION 307 IPC),967,1220,14,1031,1142,9997,11139,0,10165,974,473,501
TOTAL (ALL-INDIA),ATTEMPT TO COMMIT MURDER (SECTION 307 IPC),28756,82669,3424,30980,77021,378606,455627,863,403711,51053,12586,38467
ANDHRA PRADESH,"CULPABALE HOMICIDE NOT AMOUNTING TO MURDER (SECTION 304, 308 IPC)",120,296,0,125,291,656,947,4,677,266,22,244
ARUNACHAL PRADESH,"CULPABALE HOMICIDE NOT AMOUNTING TO MURDER (SECTION 304, 308 IPC)",1,1,0,0,2,59,61,0,61,0,0,0
ASSAM,"CULPABALE HOMICIDE NOT AMOUNTING TO MURDER (SECTION 304, 308 IPC)",109,52,15,123,23,163,186,0,145,41,1,40
BIHAR,"CULPABALE HOMICIDE NOT AMOUNTING TO MURDER (SECTION 304, 308 IPC)",555,527,43,500,539,2467,3006,0,2633,373,51,322
CHHATTISGARH,"CULPABALE HOMICIDE NOT AMOUNTING TO MURDER (SECTION 304, 308 IPC)",6,35,0,2,39,170,209,52,132,25,8,17
GOA,"CULPABALE HOMICIDE NOT AMOUNTING TO MURDER (SECTION 304, 308 IPC)",3,5,0,5,3,41,44,0,39,5,2,3
GUJARAT,"CULPABALE HOMICIDE NOT AMOUNTING TO MURDER (SECTION 304, 308 IPC)",7,62,0,6,63,746,809,0,798,11,1,10
HARYANA,"CULPABALE HOMICIDE NOT AMOUNTING TO MURDER (SECTION 304, 308 IPC)",13,92,0,9,96,444,540,0,444,96,12,84
HIMACHAL PRADESH,"CULPABALE HOMICIDE NOT AMOUNTING TO MURDER (SECTION 304, 308 IPC)",11,20,2,3,26,116,142,0,124,18,7,11
JAMMU & KASHMIR,"CULPABALE HOMICIDE NOT AMOUNTING TO MURDER (SECTION 304, 308 IPC)",2,22,0,2,22,188,210,0,166,44,7,37
JHARKHAND,"CULPABALE HOMICIDE NOT AMOUNTING TO MURDER (SECTION 304, 308 IPC)",24,128,0,42,110,360,470,1,369,100,28,72
KARNATAKA,"CULPABALE HOMICIDE NOT AMOUNTING TO MURDER (SECTION 304, 308 IPC)",28,84,1,21,90,267,357,0,231,126,0,126
KERALA,"CULPABALE HOMICIDE NOT AMOUNTING TO MURDER (SECTION 304, 308 IPC)",90,168,0,107,151,921,1072,0,1007,65,3,62
MADHYA PRADESH,"CULPABALE HOMICIDE NOT AMOUNTING TO MURDER (SECTION 304, 308 IPC)",16,190,0,9,197,791,988,0,672,316,58,258
MAHARASHTRA,"CULPABALE HOMICIDE NOT AMOUNTING TO MURDER (SECTION 304, 308 IPC)",134,367,3,167,331,2319,2650,11,2529,110,13,97
MANIPUR,"CULPABALE HOMICIDE NOT AMOUNTING TO MURDER (SECTION 304, 308 IPC)",3,8,5,5,1,19,20,0,20,0,0,0
MEGHALAYA,"CULPABALE HOMICIDE NOT AMOUNTING TO MURDER (SECTION 304, 308 IPC)",24,7,2,26,3,41,44,0,44,0,0,0
MIZORAM,"CULPABALE HOMICIDE NOT AMOUNTING TO MURDER (SECTION 304, 308 IPC)",6,11,0,14,3,4,7,0,4,3,2,1
NAGALAND,"CULPABALE HOMICIDE NOT AMOUNTING TO MURDER (SECTION 304, 308 IPC)",5,16,0,2,19,8,27,0,4,23,8,15
ODISHA,"CULPABALE HOMICIDE NOT AMOUNTING TO MURDER (SECTION 304, 308 IPC)",3,91,0,15,79,318,397,0,343,54,23,31
PUNJAB,"CULPABALE HOMICIDE NOT AMOUNTING TO MURDER (SECTION 304, 308 IPC)",235,157,5,264,123,530,653,1,547,105,35,70
RAJASTHAN,"CULPABALE HOMICIDE NOT AMOUNTING TO MURDER (SECTION 304, 308 IPC)",0,91,0,0,91,459,550,2,454,94,35,59
SIKKIM,"CULPABALE HOMICIDE NOT AMOUNTING TO MURDER (SECTION 304, 308 IPC)",2,0,0,0,2,3,5,0,4,1,1,0
TAMIL NADU,"CULPABALE HOMICIDE NOT AMOUNTING TO MURDER (SECTION 304, 308 IPC)",30,45,0,34,41,88,129,0,93,36,2,34
TRIPURA,"CULPABALE HOMICIDE NOT AMOUNTING TO MURDER (SECTION 304, 308 IPC)",0,1,0,0,1,11,12,0,10,2,2,0
UTTAR PRADESH,"CULPABALE HOMICIDE NOT AMOUNTING TO MURDER (SECTION 304, 308 IPC)",517,3849,803,524,3039,12329,15368,27,13166,2175,1089,1086
UTTARAKHAND,"CULPABALE HOMICIDE NOT AMOUNTING TO MURDER (SECTION 304, 308 IPC)",24,64,6,14,68,376,444,0,364,80,48,32
WEST BENGAL,"CULPABALE HOMICIDE NOT AMOUNTING TO MURDER (SECTION 304, 308 IPC)",820,633,58,759,636,5614,6250,1,5689,560,57,503
TOTAL (STATES),"CULPABALE HOMICIDE NOT AMOUNTING TO MURDER (SECTION 304, 308 IPC)",2788,7022,943,2778,6089,29508,35597,99,30769,4729,1515,3214
A & N ISLANDS,"CULPABALE HOMICIDE NOT AMOUNTING TO MURDER (SECTION 304, 308 IPC)",4,0,0,0,4,45,49,0,48,1,0,1
CHANDIGARH,"CULPABALE HOMICIDE NOT AMOUNTING TO MURDER (SECTION 304, 308 IPC)",2,12,0,10,4,36,40,0,29,11,1,10
D & N HAVELI,"CULPABALE HOMICIDE NOT AMOUNTING TO MURDER (SECTION 304, 308 IPC)",0,0,0,0,0,6,6,0,6,0,0,0
DAMAN & DIU,"CULPABALE HOMICIDE NOT AMOUNTING TO MURDER (SECTION 304, 308 IPC)",0,0,0,0,0,7,7,0,1,6,0,6
DELHI,"CULPABALE HOMICIDE NOT AMOUNTING TO MURDER (SECTION 304, 308 IPC)",67,93,0,83,77,1640,1717,0,1554,163,89,74
LAKSHADWEEP,"CULPABALE HOMICIDE NOT AMOUNTING TO MURDER (SECTION 304, 308 IPC)",0,0,0,0,0,0,0,0,0,0,0,0
PUDUCHERRY,"CULPABALE HOMICIDE NOT AMOUNTING TO MURDER (SECTION 304, 308 IPC)",4,21,0,16,9,111,120,0,108,12,0,12
TOTAL (UTs),"CULPABALE HOMICIDE NOT AMOUNTING TO MURDER (SECTION 304, 308 IPC)",77,126,0,109,94,1845,1939,0,1746,193,90,103
TOTAL (ALL-INDIA),"CULPABALE HOMICIDE NOT AMOUNTING TO MURDER (SECTION 304, 308 IPC)",2865,7148,943,2887,6183,31353,37536,99,32515,4922,1605,3317
ANDHRA PRADESH,RAPE (SECTION 376 IPC),783,1664,0,839,1608,3550,5158,17,3730,1411,178,1233
ARUNACHAL PRADESH,RAPE (SECTION 376 IPC),26,47,3,46,24,612,636,1,605,30,3,27
ASSAM,RAPE (SECTION 376 IPC),1668,1626,392,1746,1156,4642,5798,0,4840,958,153,805
BIHAR,RAPE (SECTION 376 IPC),1103,1327,94,938,1398,4642,6040,0,5095,945,161,784
CHHATTISGARH,RAPE (SECTION 376 IPC),93,1214,0,106,1201,5064,6265,0,5141,1124,259,865
GOA,RAPE (SECTION 376 IPC),28,61,2,52,35,153,188,1,170,17,1,16
GUJARAT,RAPE (SECTION 376 IPC),68,647,0,84,631,5057,5688,4,5369,315,56,259
HARYANA,RAPE (SECTION 376 IPC),99,940,0,42,997,1557,2554,0,1708,846,180,666
HIMACHAL PRADESH,RAPE (SECTION 376 IPC),46,259,8,57,240,743,983,2,831,150,41,109
JAMMU & KASHMIR,RAPE (SECTION 376 IPC),14,388,0,15,387,1588,1975,8,1592,375,28,347
JHARKHAND,RAPE (SECTION 376 IPC),363,780,0,437,706,1525,2231,11,1541,679,196,483
KARNATAKA,RAPE (SECTION 376 IPC),172,842,20,199,795,1927,2722,4,2075,643,97,546
KERALA,RAPE (SECTION 376 IPC),795,1259,3,865,1186,4805,5991,0,5694,297,62,235
MADHYA PRADESH,RAPE (SECTION 376 IPC),65,4822,0,45,4842,12468,17310,116,13496,3698,758,2940
MAHARASHTRA,RAPE (SECTION 376 IPC),894,2591,10,996,2479,19097,21576,20,20002,1554,215,1339
MANIPUR,RAPE (SECTION 376 IPC),46,46,26,54,12,85,97,1,95,1,0,1
MEGHALAYA,RAPE (SECTION 376 IPC),266,182,44,304,100,605,705,0,690,15,7,8
MIZORAM,RAPE (SECTION 376 IPC),16,122,0,42,96,112,208,0,136,72,59,13
NAGALAND,RAPE (SECTION 376 IPC),8,26,5,8,21,34,55,0,33,22,19,3
ODISHA,RAPE (SECTION 376 IPC),121,1666,4,152,1631,5407,7038,0,6098,940,184,756
PUNJAB,RAPE (SECTION 376 IPC),354,895,43,510,696,716,1412,2,820,590,201,389
RAJASTHAN,RAPE (SECTION 376 IPC),8,1807,0,37,1778,5427,7205,35,5994,1176,408,768
SIKKIM,RAPE (SECTION 376 IPC),12,29,5,16,20,75,95,0,45,50,18,32
TAMIL NADU,RAPE (SECTION 376 IPC),761,962,62,799,862,2024,2886,0,2420,466,104,362
TRIPURA,RAPE (SECTION 376 IPC),90,202,42,35,215,268,483,0,360,123,19,104
UTTAR PRADESH,RAPE (SECTION 376 IPC),278,3593,1009,354,2508,6372,8880,54,7075,1751,809,942
UTTARAKHAND,RAPE (SECTION 376 IPC),20,184,0,17,187,366,553,0,381,172,93,79
WEST BENGAL,RAPE (SECTION 376 IPC),847,1963,71,574,2165,13454,15619,36,14140,1443,124,1319
TOTAL (STATES),RAPE (SECTION 376 IPC),9044,30144,1843,9369,27976,102375,130351,312,110176,19863,4433,15430
A & N ISLANDS,RAPE (SECTION 376 IPC),13,17,0,15,15,156,171,0,163,8,3,5
CHANDIGARH,RAPE (SECTION 376 IPC),12,34,0,5,41,68,109,0,75,34,11,23
D & N HAVELI,RAPE (SECTION 376 IPC),3,5,0,0,8,14,22,0,15,7,2,5
DAMAN & DIU,RAPE (SECTION 376 IPC),0,10,0,1,9,6,15,0,12,3,1,2
DELHI,RAPE (SECTION 376 IPC),355,892,16,369,862,2320,3182,0,2442,740,368,372
LAKSHADWEEP,RAPE (SECTION 376 IPC),0,0,0,0,0,0,0,0,0,0,0,0
PUDUCHERRY,RAPE (SECTION 376 IPC),16,15,0,17,14,58,72,0,67,5,3,2
TOTAL (UTs),RAPE (SECTION 376 IPC),399,973,16,407,949,2622,3571,0,2774,797,388,409
TOTAL (ALL-INDIA),RAPE (SECTION 376 IPC),9443,31117,1859,9776,28925,104997,133922,312,112950,20660,4821,15839
ANDHRA PRADESH,UNDER CUSTODIAL RAPE,0,0,0,0,0,0,0,0,0,0,0,0
ARUNACHAL PRADESH,UNDER CUSTODIAL RAPE,0,0,0,0,0,0,0,0,0,0,0,0
ASSAM,UNDER CUSTODIAL RAPE,0,0,0,0,0,3,3,0,3,0,0,0
BIHAR,UNDER CUSTODIAL RAPE,0,0,0,0,0,1,1,0,1,0,0,0
CHHATTISGARH,UNDER CUSTODIAL RAPE,0,0,0,0,0,0,0,0,0,0,0,0
GOA,UNDER CUSTODIAL RAPE,0,0,0,0,0,0,0,0,0,0,0,0
GUJARAT,UNDER CUSTODIAL RAPE,0,0,0,0,0,0,0,0,0,0,0,0
HARYANA,UNDER CUSTODIAL RAPE,0,0,0,0,0,0,0,0,0,0,0,0
HIMACHAL PRADESH,UNDER CUSTODIAL RAPE,0,0,0,0,0,0,0,0,0,0,0,0
JAMMU & KASHMIR,UNDER CUSTODIAL RAPE,0,0,0,0,0,0,0,0,0,0,0,0
JHARKHAND,UNDER CUSTODIAL RAPE,0,0,0,0,0,0,0,0,0,0,0,0
KARNATAKA,UNDER CUSTODIAL RAPE,0,0,0,0,0,0,0,0,0,0,0,0
KERALA,UNDER CUSTODIAL RAPE,0,0,0,0,0,0,0,0,0,0,0,0
MADHYA PRADESH,UNDER CUSTODIAL RAPE,0,0,0,0,0,6,6,0,6,0,0,0
MAHARASHTRA,UNDER CUSTODIAL RAPE,0,0,0,0,0,0,0,0,0,0,0,0
MANIPUR,UNDER CUSTODIAL RAPE,0,0,0,0,0,0,0,0,0,0,0,0
MEGHALAYA,UNDER CUSTODIAL RAPE,0,0,0,0,0,0,0,0,0,0,0,0
MIZORAM,UNDER CUSTODIAL RAPE,0,0,0,0,0,1,1,0,1,0,0,0
NAGALAND,UNDER CUSTODIAL RAPE,0,0,0,0,0,0,0,0,0,0,0,0
ODISHA,UNDER CUSTODIAL RAPE,0,0,0,0,0,0,0,0,0,0,0,0
PUNJAB,UNDER CUSTODIAL RAPE,0,1,0,0,1,0,1,0,0,1,0,1
RAJASTHAN,UNDER CUSTODIAL RAPE,0,0,0,0,0,0,0,0,0,0,0,0
SIKKIM,UNDER CUSTODIAL RAPE,0,0,0,0,0,0,0,0,0,0,0,0
TAMIL NADU,UNDER CUSTODIAL RAPE,0,0,0,0,0,0,0,0,0,0,0,0
TRIPURA,UNDER CUSTODIAL RAPE,0,0,0,0,0,0,0,0,0,0,0,0
UTTAR PRADESH,UNDER CUSTODIAL RAPE,0,0,0,0,0,0,0,0,0,0,0,0
UTTARAKHAND,UNDER CUSTODIAL RAPE,0,0,0,0,0,0,0,0,0,0,0,0
WEST BENGAL,UNDER CUSTODIAL RAPE,0,0,0,0,0,0,0,0,0,0,0,0
TOTAL (STATES),UNDER CUSTODIAL RAPE,0,1,0,0,1,11,12,0,11,1,0,1
A & N ISLANDS,UNDER CUSTODIAL RAPE,0,0,0,0,0,0,0,0,0,0,0,0
CHANDIGARH,UNDER CUSTODIAL RAPE,0,0,0,0,0,0,0,0,0,0,0,0
D & N HAVELI,UNDER CUSTODIAL RAPE,0,0,0,0,0,0,0,0,0,0,0,0
DAMAN & DIU,UNDER CUSTODIAL RAPE,0,0,0,0,0,0,0,0,0,0,0,0
DELHI,UNDER CUSTODIAL RAPE,0,0,0,0,0,0,0,0,0,0,0,0
LAKSHADWEEP,UNDER CUSTODIAL RAPE,0,0,0,0,0,0,0,0,0,0,0,0
PUDUCHERRY,UNDER CUSTODIAL RAPE,0,0,0,0,0,0,0,0,0,0,0,0
TOTAL (UTs),UNDER CUSTODIAL RAPE,0,0,0,0,0,0,0,0,0,0,0,0
TOTAL (ALL-INDIA),UNDER CUSTODIAL RAPE,0,1,0,0,1,11,12,0,11,1,0,1
ANDHRA PRADESH,UNDER OTHER RAPE,783,1664,0,839,1608,3550,5158,17,3730,1411,178,1233
ARUNACHAL PRADESH,UNDER OTHER RAPE,26,47,3,46,24,612,636,1,605,30,3,27
ASSAM,UNDER OTHER RAPE,1668,1626,392,1746,1156,4639,5795,0,4837,958,153,805
BIHAR,UNDER OTHER RAPE,1103,1327,94,938,1398,4641,6039,0,5094,945,161,784
CHHATTISGARH,UNDER OTHER RAPE,93,1214,0,106,1201,5064,6265,0,5141,1124,259,865
GOA,UNDER OTHER RAPE,28,61,2,52,35,153,188,1,170,17,1,16
GUJARAT,UNDER OTHER RAPE,68,647,0,84,631,5057,5688,4,5369,315,56,259
HARYANA,UNDER OTHER RAPE,99,940,0,42,997,1557,2554,0,1708,846,180,666
HIMACHAL PRADESH,UNDER OTHER RAPE,46,259,8,57,240,743,983,2,831,150,41,109
JAMMU & KASHMIR,UNDER OTHER RAPE,14,388,0,15,387,1588,1975,8,1592,375,28,347
JHARKHAND,UNDER OTHER RAPE,363,780,0,437,706,1525,2231,11,1541,679,196,483
KARNATAKA,UNDER OTHER RAPE,172,842,20,199,795,1927,2722,4,2075,643,97,546
KERALA,UNDER OTHER RAPE,795,1259,3,865,1186,4805,5991,0,5694,297,62,235
MADHYA PRADESH,UNDER OTHER RAPE,65,4822,0,45,4842,12462,17304,116,13490,3698,758,2940
MAHARASHTRA,UNDER OTHER RAPE,894,2591,10,996,2479,19097,21576,20,20002,1554,215,1339
MANIPUR,UNDER OTHER RAPE,46,46,26,54,12,85,97,1,95,1,0,1
MEGHALAYA,UNDER OTHER RAPE,266,182,44,304,100,605,705,0,690,15,7,8
MIZORAM,UNDER OTHER RAPE,16,122,0,42,96,111,207,0,135,72,59,13
NAGALAND,UNDER OTHER RAPE,8,26,5,8,21,34,55,0,33,22,19,3
ODISHA,UNDER OTHER RAPE,121,1666,4,152,1631,5407,7038,0,6098,940,184,756
PUNJAB,UNDER OTHER RAPE,354,894,43,510,695,716,1411,2,820,589,201,388
RAJASTHAN,UNDER OTHER RAPE,8,1807,0,37,1778,5427,7205,35,5994,1176,408,768
SIKKIM,UNDER OTHER RAPE,12,29,5,16,20,75,95,0,45,50,18,32
TAMIL NADU,UNDER OTHER RAPE,761,962,62,799,862,2024,2886,0,2420,466,104,362
TRIPURA,UNDER OTHER RAPE,90,202,42,35,215,268,483,0,360,123,19,104
UTTAR PRADESH,UNDER OTHER RAPE,278,3593,1009,354,2508,6372,8880,54,7075,1751,809,942
UTTARAKHAND,UNDER OTHER RAPE,20,184,0,17,187,366,553,0,381,172,93,79
WEST BENGAL,UNDER OTHER RAPE,847,1963,71,574,2165,13454,15619,36,14140,1443,124,1319
TOTAL (STATES),UNDER OTHER RAPE,9044,30143,1843,9369,27975,102364,130339,312,110165,19862,4433,15429
A & N ISLANDS,UNDER OTHER RAPE,13,17,0,15,15,156,171,0,163,8,3,5
CHANDIGARH,UNDER OTHER RAPE,12,34,0,5,41,68,109,0,75,34,11,23
D & N HAVELI,UNDER OTHER RAPE,3,5,0,0,8,14,22,0,15,7,2,5
DAMAN & DIU,UNDER OTHER RAPE,0,10,0,1,9,6,15,0,12,3,1,2
DELHI,UNDER OTHER RAPE,355,892,16,369,862,2320,3182,0,2442,740,368,372
LAKSHADWEEP,UNDER OTHER RAPE,0,0,0,0,0,0,0,0,0,0,0,0
PUDUCHERRY,UNDER OTHER RAPE,16,15,0,17,14,58,72,0,67,5,3,2
TOTAL (UTs),UNDER OTHER RAPE,399,973,16,407,949,2622,3571,0,2774,797,388,409
TOTAL (ALL-INDIA),UNDER OTHER RAPE,9443,31116,1859,9776,28924,104986,133910,312,112939,20659,4821,15838
ANDHRA PRADESH,"KIDNAPPING AND ABDUCTION (SECTION 363 TO 369, 371 TO 373 IPC)",1139,2555,0,1140,2554,5177,7731,115,5723,1893,158,1735
ARUNACHAL PRADESH,"KIDNAPPING AND ABDUCTION (SECTION 363 TO 369, 371 TO 373 IPC)",75,70,37,61,47,710,757,9,717,31,8,23
ASSAM,"KIDNAPPING AND ABDUCTION (SECTION 363 TO 369, 371 TO 373 IPC)",3794,3199,1481,3950,1562,4758,6320,0,4663,1657,106,1551
BIHAR,"KIDNAPPING AND ABDUCTION (SECTION 363 TO 369, 371 TO 373 IPC)",5296,6700,123,6032,5841,27732,33573,6,30505,3062,242,2820
CHHATTISGARH,"KIDNAPPING AND ABDUCTION (SECTION 363 TO 369, 371 TO 373 IPC)",90,574,0,91,573,1956,2529,0,2177,352,107,245
GOA,"KIDNAPPING AND ABDUCTION (SECTION 363 TO 369, 371 TO 373 IPC)",39,17,0,43,13,131,144,0,138,6,1,5
GUJARAT,"KIDNAPPING AND ABDUCTION (SECTION 363 TO 369, 371 TO 373 IPC)",297,2422,11,359,2349,19129,21478,42,20532,904,53,851
HARYANA,"KIDNAPPING AND ABDUCTION (SECTION 363 TO 369, 371 TO 373 IPC)",172,1130,0,157,1145,3071,4216,0,3407,809,110,699
HIMACHAL PRADESH,"KIDNAPPING AND ABDUCTION (SECTION 363 TO 369, 371 TO 373 IPC)",71,141,6,65,141,646,787,5,687,95,16,79
JAMMU & KASHMIR,"KIDNAPPING AND ABDUCTION (SECTION 363 TO 369, 371 TO 373 IPC)",13,961,0,13,961,7042,8003,26,7129,848,4,844
JHARKHAND,"KIDNAPPING AND ABDUCTION (SECTION 363 TO 369, 371 TO 373 IPC)",591,1368,0,635,1324,2031,3355,8,2534,813,240,573
KARNATAKA,"KIDNAPPING AND ABDUCTION (SECTION 363 TO 369, 371 TO 373 IPC)",447,1994,62,396,1983,3018,5001,38,3400,1563,59,1504
KERALA,"KIDNAPPING AND ABDUCTION (SECTION 363 TO 369, 371 TO 373 IPC)",198,395,7,191,395,2300,2695,0,2522,173,6,167
MADHYA PRADESH,"KIDNAPPING AND ABDUCTION (SECTION 363 TO 369, 371 TO 373 IPC)",101,2087,0,114,2074,6996,9070,28,7292,1750,470,1280
MAHARASHTRA,"KIDNAPPING AND ABDUCTION (SECTION 363 TO 369, 371 TO 373 IPC)",1353,2703,64,1537,2455,21160,23615,43,22234,1338,65,1273
MANIPUR,"KIDNAPPING AND ABDUCTION (SECTION 363 TO 369, 371 TO 373 IPC)",167,150,150,165,2,67,69,0,68,1,0,1
MEGHALAYA,"KIDNAPPING AND ABDUCTION (SECTION 363 TO 369, 371 TO 373 IPC)",355,94,18,377,54,330,384,0,373,11,0,11
MIZORAM,"KIDNAPPING AND ABDUCTION (SECTION 363 TO 369, 371 TO 373 IPC)",5,7,1,7,4,10,14,0,9,5,5,0
NAGALAND,"KIDNAPPING AND ABDUCTION (SECTION 363 TO 369, 371 TO 373 IPC)",43,29,2,19,51,21,72,0,23,49,41,8
ODISHA,"KIDNAPPING AND ABDUCTION (SECTION 363 TO 369, 371 TO 373 IPC)",210,1592,12,232,1558,4894,6452,0,5669,783,53,730
PUNJAB,"KIDNAPPING AND ABDUCTION (SECTION 363 TO 369, 371 TO 373 IPC)",1050,1068,91,1362,665,2468,3133,3,2728,402,90,312
RAJASTHAN,"KIDNAPPING AND ABDUCTION (SECTION 363 TO 369, 371 TO 373 IPC)",95,2194,0,86,2203,12844,15047,85,13308,1654,526,1128
SIKKIM,"KIDNAPPING AND ABDUCTION (SECTION 363 TO 369, 371 TO 373 IPC)",1,8,0,4,5,18,23,0,18,5,2,3
TAMIL NADU,"KIDNAPPING AND ABDUCTION (SECTION 363 TO 369, 371 TO 373 IPC)",2080,1962,121,2057,1864,3785,5649,0,4268,1381,169,1212
TRIPURA,"KIDNAPPING AND ABDUCTION (SECTION 363 TO 369, 371 TO 373 IPC)",56,144,15,8,177,160,337,0,267,70,7,63
UTTAR PRADESH,"KIDNAPPING AND ABDUCTION (SECTION 363 TO 369, 371 TO 373 IPC)",3827,23045,10546,5172,11154,24063,35217,446,29159,5612,2715,2897
UTTARAKHAND,"KIDNAPPING AND ABDUCTION (SECTION 363 TO 369, 371 TO 373 IPC)",68,266,4,51,279,1304,1583,0,1255,328,189,139
WEST BENGAL,"KIDNAPPING AND ABDUCTION (SECTION 363 TO 369, 371 TO 373 IPC)",1564,4376,507,1596,3837,14507,18344,58,16817,1469,62,1407
TOTAL (STATES),"KIDNAPPING AND ABDUCTION (SECTION 363 TO 369, 371 TO 373 IPC)",23197,61251,13258,25920,45270,170328,215598,912,187622,27064,5504,21560
A & N ISLANDS,"KIDNAPPING AND ABDUCTION (SECTION 363 TO 369, 371 TO 373 IPC)",10,7,0,10,7,85,92,0,90,2,1,1
CHANDIGARH,"KIDNAPPING AND ABDUCTION (SECTION 363 TO 369, 371 TO 373 IPC)",35,71,0,14,92,101,193,0,140,53,33,20
D & N HAVELI,"KIDNAPPING AND ABDUCTION (SECTION 363 TO 369, 371 TO 373 IPC)",4,19,0,1,22,119,141,0,132,9,1,8
DAMAN & DIU,"KIDNAPPING AND ABDUCTION (SECTION 363 TO 369, 371 TO 373 IPC)",8,1,0,1,8,9,17,0,9,8,0,8
DELHI,"KIDNAPPING AND ABDUCTION (SECTION 363 TO 369, 371 TO 373 IPC)",228,653,75,237,569,3397,3966,0,3211,755,314,441
LAKSHADWEEP,"KIDNAPPING AND ABDUCTION (SECTION 363 TO 369, 371 TO 373 IPC)",0,0,0,0,0,0,0,0,0,0,0,0
PUDUCHERRY,"KIDNAPPING AND ABDUCTION (SECTION 363 TO 369, 371 TO 373 IPC)",8,18,0,4,22,136,158,0,145,13,5,8
TOTAL (UTs),"KIDNAPPING AND ABDUCTION (SECTION 363 TO 369, 371 TO 373 IPC)",293,769,75,267,720,3847,4567,0,3727,840,354,486
TOTAL (ALL-INDIA),"KIDNAPPING AND ABDUCTION (SECTION 363 TO 369, 371 TO 373 IPC)",23490,62020,13333,26187,45990,174175,220165,912,191349,27904,5858,22046
ANDHRA PRADESH,KIDNAPPING AND ABDUCTION OF WOMEN AND GIRLS,822,1764,0,786,1800,3403,5203,98,3785,1320,108,1212
ARUNACHAL PRADESH,KIDNAPPING AND ABDUCTION OF WOMEN AND GIRLS,47,49,22,40,34,503,537,9,498,30,7,23
ASSAM,KIDNAPPING AND ABDUCTION OF WOMEN AND GIRLS,2985,2689,1071,3265,1338,3553,4891,0,3475,1416,80,1336
BIHAR,KIDNAPPING AND ABDUCTION OF WOMEN AND GIRLS,2540,4639,32,3491,3656,11968,15624,6,14147,1471,92,1379
CHHATTISGARH,KIDNAPPING AND ABDUCTION OF WOMEN AND GIRLS,82,441,0,84,439,1624,2063,0,1775,288,89,199
GOA,KIDNAPPING AND ABDUCTION OF WOMEN AND GIRLS,14,12,0,14,12,60,72,0,70,2,0,2
GUJARAT,KIDNAPPING AND ABDUCTION OF WOMEN AND GIRLS,256,1939,1,316,1878,13997,15875,41,15082,752,51,701
HARYANA,KIDNAPPING AND ABDUCTION OF WOMEN AND GIRLS,101,660,0,56,705,1538,2243,0,1760,483,62,421
HIMACHAL PRADESH,KIDNAPPING AND ABDUCTION OF WOMEN AND GIRLS,53,131,6,49,129,415,544,5,461,78,16,62
JAMMU & KASHMIR,KIDNAPPING AND ABDUCTION OF WOMEN AND GIRLS,10,884,0,10,884,6711,7595,25,6791,779,2,777
JHARKHAND,KIDNAPPING AND ABDUCTION OF WOMEN AND GIRLS,279,1000,0,330,949,1207,2156,8,1576,572,162,410
KARNATAKA,KIDNAPPING AND ABDUCTION OF WOMEN AND GIRLS,248,1035,42,231,1010,1769,2779,24,2176,579,44,535
KERALA,KIDNAPPING AND ABDUCTION OF WOMEN AND GIRLS,108,253,3,106,252,1181,1433,0,1328,105,6,99
MADHYA PRADESH,KIDNAPPING AND ABDUCTION OF WOMEN AND GIRLS,77,1648,0,104,1621,5139,6760,11,5376,1373,383,990
MAHARASHTRA,KIDNAPPING AND ABDUCTION OF WOMEN AND GIRLS,877,1775,37,959,1656,13245,14901,25,13984,892,32,860
MANIPUR,KIDNAPPING AND ABDUCTION OF WOMEN AND GIRLS,113,101,111,101,2,53,55,0,54,1,0,1
MEGHALAYA,KIDNAPPING AND ABDUCTION OF WOMEN AND GIRLS,76,6,4,66,12,106,118,0,114,4,0,4
MIZORAM,KIDNAPPING AND ABDUCTION OF WOMEN AND GIRLS,0,3,0,0,3,0,3,0,1,2,2,0
NAGALAND,KIDNAPPING AND ABDUCTION OF WOMEN AND GIRLS,3,7,2,3,5,4,9,0,5,4,3,1
ODISHA,KIDNAPPING AND ABDUCTION OF WOMEN AND GIRLS,148,1347,0,168,1327,4029,5356,0,4685,671,46,625
PUNJAB,KIDNAPPING AND ABDUCTION OF WOMEN AND GIRLS,619,731,72,868,410,1530,1940,3,1726,211,44,167
RAJASTHAN,KIDNAPPING AND ABDUCTION OF WOMEN AND GIRLS,64,1565,0,66,1563,9380,10943,44,9685,1214,370,844
SIKKIM,KIDNAPPING AND ABDUCTION OF WOMEN AND GIRLS,1,8,0,4,5,18,23,0,18,5,2,3
TAMIL NADU,KIDNAPPING AND ABDUCTION OF WOMEN AND GIRLS,1714,1557,99,1656,1516,2827,4343,0,3199,1144,119,1025
TRIPURA,KIDNAPPING AND ABDUCTION OF WOMEN AND GIRLS,43,120,11,6,146,152,298,0,244,54,7,47
UTTAR PRADESH,KIDNAPPING AND ABDUCTION OF WOMEN AND GIRLS,3247,20565,9599,4389,9824,16959,26783,415,21929,4439,2155,2284
UTTARAKHAND,KIDNAPPING AND ABDUCTION OF WOMEN AND GIRLS,47,242,4,44,241,1047,1288,0,1026,262,152,110
WEST BENGAL,KIDNAPPING AND ABDUCTION OF WOMEN AND GIRLS,1308,3352,413,1253,2994,12461,15455,45,14294,1116,38,1078
TOTAL (STATES),KIDNAPPING AND ABDUCTION OF WOMEN AND GIRLS,15882,48523,11529,18465,34411,114879,149290,759,129264,19267,4072,15195
A & N ISLANDS,KIDNAPPING AND ABDUCTION OF WOMEN AND GIRLS,1,7,0,1,7,67,74,0,72,2,1,1
CHANDIGARH,KIDNAPPING AND ABDUCTION OF WOMEN AND GIRLS,22,48,0,9,61,44,105,0,83,22,6,16
D & N HAVELI,KIDNAPPING AND ABDUCTION OF WOMEN AND GIRLS,2,11,0,1,12,50,62,0,54,8,1,7
DAMAN & DIU,KIDNAPPING AND ABDUCTION OF WOMEN AND GIRLS,8,0,0,0,8,4,12,0,6,6,0,6
DELHI,KIDNAPPING AND ABDUCTION OF WOMEN AND GIRLS,106,478,42,120,422,1753,2175,0,1675,500,190,310
LAKSHADWEEP,KIDNAPPING AND ABDUCTION OF WOMEN AND GIRLS,0,0,0,0,0,0,0,0,0,0,0,0
PUDUCHERRY,KIDNAPPING AND ABDUCTION OF WOMEN AND GIRLS,3,16,0,4,15,64,79,0,72,7,3,4
TOTAL (UTs),KIDNAPPING AND ABDUCTION OF WOMEN AND GIRLS,142,560,42,135,525,1982,2507,0,1962,545,201,344
TOTAL (ALL-INDIA),KIDNAPPING AND ABDUCTION OF WOMEN AND GIRLS,16024,49083,11571,18600,34936,116861,151797,759,131226,19812,4273,15539
ANDHRA PRADESH,KIDNAPPING AND ABDUCTION OF OTHERS,317,791,0,354,754,1774,2528,17,1938,573,50,523
ARUNACHAL PRADESH,KIDNAPPING AND ABDUCTION OF OTHERS,28,21,15,21,13,207,220,0,219,1,1,0
ASSAM,KIDNAPPING AND ABDUCTION OF OTHERS,809,510,410,685,224,1205,1429,0,1188,241,26,215
BIHAR,KIDNAPPING AND ABDUCTION OF OTHERS,2756,2061,91,2541,2185,15764,17949,0,16358,1591,150,1441
CHHATTISGARH,KIDNAPPING AND ABDUCTION OF OTHERS,8,133,0,7,134,332,466,0,402,64,18,46
GOA,KIDNAPPING AND ABDUCTION OF OTHERS,25,5,0,29,1,71,72,0,68,4,1,3
GUJARAT,KIDNAPPING AND ABDUCTION OF OTHERS,41,483,10,43,471,5132,5603,1,5450,152,2,150
HARYANA,KIDNAPPING AND ABDUCTION OF OTHERS,71,470,0,101,440,1533,1973,0,1647,326,48,278
HIMACHAL PRADESH,KIDNAPPING AND ABDUCTION OF OTHERS,18,10,0,16,12,231,243,0,226,17,0,17
JAMMU & KASHMIR,KIDNAPPING AND ABDUCTION OF OTHERS,3,77,0,3,77,331,408,1,338,69,2,67
JHARKHAND,KIDNAPPING AND ABDUCTION OF OTHERS,312,368,0,305,375,824,1199,0,958,241,78,163
KARNATAKA,KIDNAPPING AND ABDUCTION OF OTHERS,199,959,20,165,973,1249,2222,14,1224,984,15,969
KERALA,KIDNAPPING AND ABDUCTION OF OTHERS,90,142,4,85,143,1119,1262,0,1194,68,0,68
MADHYA PRADESH,KIDNAPPING AND ABDUCTION OF OTHERS,24,439,0,10,453,1857,2310,17,1916,377,87,290
MAHARASHTRA,KIDNAPPING AND ABDUCTION OF OTHERS,476,928,27,578,799,7915,8714,18,8250,446,33,413
MANIPUR,KIDNAPPING AND ABDUCTION OF OTHERS,54,49,39,64,0,14,14,0,14,0,0,0
MEGHALAYA,KIDNAPPING AND ABDUCTION OF OTHERS,279,88,14,311,42,224,266,0,259,7,0,7
MIZORAM,KIDNAPPING AND ABDUCTION OF OTHERS,5,4,1,7,1,10,11,0,8,3,3,0
NAGALAND,KIDNAPPING AND ABDUCTION OF OTHERS,40,22,0,16,46,17,63,0,18,45,38,7
ODISHA,KIDNAPPING AND ABDUCTION OF OTHERS,62,245,12,64,231,865,1096,0,984,112,7,105
PUNJAB,KIDNAPPING AND ABDUCTION OF OTHERS,431,337,19,494,255,938,1193,0,1002,191,46,145
RAJASTHAN,KIDNAPPING AND ABDUCTION OF OTHERS,31,629,0,20,640,3464,4104,41,3623,440,156,284
SIKKIM,KIDNAPPING AND ABDUCTION OF OTHERS,0,0,0,0,0,0,0,0,0,0,0,0
TAMIL NADU,KIDNAPPING AND ABDUCTION OF OTHERS,366,405,22,401,348,958,1306,0,1069,237,50,187
TRIPURA,KIDNAPPING AND ABDUCTION OF OTHERS,13,24,4,2,31,8,39,0,23,16,0,16
UTTAR PRADESH,KIDNAPPING AND ABDUCTION OF OTHERS,580,2480,947,783,1330,7104,8434,31,7230,1173,560,613
UTTARAKHAND,KIDNAPPING AND ABDUCTION OF OTHERS,21,24,0,7,38,257,295,0,229,66,37,29
WEST BENGAL,KIDNAPPING AND ABDUCTION OF OTHERS,256,1024,94,343,843,2046,2889,13,2523,353,24,329
TOTAL (STATES),KIDNAPPING AND ABDUCTION OF OTHERS,7315,12728,1729,7455,10859,55449,66308,153,58358,7797,1432,6365
A & N ISLANDS,KIDNAPPING AND ABDUCTION OF OTHERS,9,0,0,9,0,18,18,0,18,0,0,0
CHANDIGARH,KIDNAPPING AND ABDUCTION OF OTHERS,13,23,0,5,31,57,88,0,57,31,27,4
D & N HAVELI,KIDNAPPING AND ABDUCTION OF OTHERS,2,8,0,0,10,69,79,0,78,1,0,1
DAMAN & DIU,KIDNAPPING AND ABDUCTION OF OTHERS,0,1,0,1,0,5,5,0,3,2,0,2
DELHI,KIDNAPPING AND ABDUCTION OF OTHERS,122,175,33,117,147,1644,1791,0,1536,255,124,131
LAKSHADWEEP,KIDNAPPING AND ABDUCTION OF OTHERS,0,0,0,0,0,0,0,0,0,0,0,0
PUDUCHERRY,KIDNAPPING AND ABDUCTION OF OTHERS,5,2,0,0,7,72,79,0,73,6,2,4
TOTAL (UTs),KIDNAPPING AND ABDUCTION OF OTHERS,151,209,33,132,195,1865,2060,0,1765,295,153,142
TOTAL (ALL-INDIA),KIDNAPPING AND ABDUCTION OF OTHERS,7466,12937,1762,7587,11054,57314,68368,153,60123,8092,1585,6507
ANDHRA PRADESH,DACOITY (SECTION 395 TO 398 IPC),350,591,0,275,666,2157,2823,5,2364,454,28,426
ARUNACHAL PRADESH,DACOITY (SECTION 395 TO 398 IPC),45,29,16,22,36,869,905,0,898,7,0,7
ASSAM,DACOITY (SECTION 395 TO 398 IPC),2474,485,323,2302,334,4247,4581,0,4163,418,56,362
BIHAR,DACOITY (SECTION 395 TO 398 IPC),1617,2610,36,2459,1732,27657,29389,0,27816,1573,176,1397
CHHATTISGARH,DACOITY (SECTION 395 TO 398 IPC),108,161,0,100,169,1634,1803,288,1081,434,102,332
GOA,DACOITY (SECTION 395 TO 398 IPC),0,27,0,21,6,129,135,0,127,8,0,8
GUJARAT,DACOITY (SECTION 395 TO 398 IPC),244,1403,5,342,1300,15776,17076,54,16567,455,23,432
HARYANA,DACOITY (SECTION 395 TO 398 IPC),85,491,0,63,513,1140,1653,0,1140,513,149,364
HIMACHAL PRADESH,DACOITY (SECTION 395 TO 398 IPC),0,1,0,1,0,82,82,0,77,5,5,0
JAMMU & KASHMIR,DACOITY (SECTION 395 TO 398 IPC),0,23,0,0,23,388,411,5,366,40,0,40
JHARKHAND,DACOITY (SECTION 395 TO 398 IPC),718,586,0,803,501,3325,3826,0,3322,504,187,317
KARNATAKA,DACOITY (SECTION 395 TO 398 IPC),140,769,16,138,755,3577,4332,9,3623,700,58,642
KERALA,DACOITY (SECTION 395 TO 398 IPC),487,365,8,385,459,5040,5499,10,5251,238,35,203
MADHYA PRADESH,DACOITY (SECTION 395 TO 398 IPC),45,725,0,43,727,2184,2911,4,2287,620,189,431
MAHARASHTRA,DACOITY (SECTION 395 TO 398 IPC),1692,4008,101,1846,3753,42824,46577,7,44008,2562,167,2395
MANIPUR,DACOITY (SECTION 395 TO 398 IPC),7,1,1,7,0,88,88,0,88,0,0,0
MEGHALAYA,DACOITY (SECTION 395 TO 398 IPC),492,74,13,500,53,1153,1206,0,1194,12,0,12
MIZORAM,DACOITY (SECTION 395 TO 398 IPC),0,1,0,1,0,6,6,0,6,0,0,0
NAGALAND,DACOITY (SECTION 395 TO 398 IPC),5,0,0,2,3,11,14,0,14,0,0,0
ODISHA,DACOITY (SECTION 395 TO 398 IPC),274,1830,0,269,1835,7853,9688,0,8593,1095,122,973
PUNJAB,DACOITY (SECTION 395 TO 398 IPC),84,146,0,104,126,357,483,0,366,117,29,88
RAJASTHAN,DACOITY (SECTION 395 TO 398 IPC),3,145,0,20,128,1561,1689,0,1499,190,74,116
SIKKIM,DACOITY (SECTION 395 TO 398 IPC),0,0,0,0,0,9,9,0,9,0,0,0
TAMIL NADU,DACOITY (SECTION 395 TO 398 IPC),361,533,7,358,529,2953,3482,0,3211,271,63,208
TRIPURA,DACOITY (SECTION 395 TO 398 IPC),21,39,14,7,39,64,103,0,93,10,0,10
UTTAR PRADESH,DACOITY (SECTION 395 TO 398 IPC),351,1941,554,353,1385,10296,11681,0,10433,1248,676,572
UTTARAKHAND,DACOITY (SECTION 395 TO 398 IPC),4,107,0,20,91,244,335,0,249,86,43,43
WEST BENGAL,DACOITY (SECTION 395 TO 398 IPC),1468,1086,77,1524,953,12597,13550,6,12792,752,81,671
TOTAL (STATES),DACOITY (SECTION 395 TO 398 IPC),11075,18177,1171,11965,16116,148221,164337,388,151637,12312,2263,10049
A & N ISLANDS,DACOITY (SECTION 395 TO 398 IPC),0,5,0,5,0,9,9,0,8,1,0,1
CHANDIGARH,DACOITY (SECTION 395 TO 398 IPC),1,18,0,0,19,34,53,0,38,15,0,15
D & N HAVELI,DACOITY (SECTION 395 TO 398 IPC),15,7,0,19,3,93,96,0,93,3,0,3
DAMAN & DIU,DACOITY (SECTION 395 TO 398 IPC),11,5,0,5,11,71,82,8,52,22,0,22
DELHI,DACOITY (SECTION 395 TO 398 IPC),118,166,1,101,182,1237,1419,0,1331,88,52,36
LAKSHADWEEP,DACOITY (SECTION 395 TO 398 IPC),0,0,0,0,0,0,0,0,0,0,0,0
PUDUCHERRY,DACOITY (SECTION 395 TO 398 IPC),23,44,0,16,51,131,182,0,182,0,0,0
TOTAL (UTs),DACOITY (SECTION 395 TO 398 IPC),168,245,1,146,266,1575,1841,8,1704,129,52,77
TOTAL (ALL-INDIA),DACOITY (SECTION 395 TO 398 IPC),11243,18422,1172,12111,16382,149796,166178,396,153341,12441,2315,10126
ANDHRA PRADESH,PREPARATION AND ASSEMBLY FOR DACOITY (SECTION 399 TO 402 IPC),15,12,0,7,20,133,153,0,108,45,0,45
ARUNACHAL PRADESH,PREPARATION AND ASSEMBLY FOR DACOITY (SECTION 399 TO 402 IPC),0,0,0,0,0,23,23,0,23,0,0,0
ASSAM,PREPARATION AND ASSEMBLY FOR DACOITY (SECTION 399 TO 402 IPC),110,14,0,113,11,367,378,0,317,61,3,58
BIHAR,PREPARATION AND ASSEMBLY FOR DACOITY (SECTION 399 TO 402 IPC),301,315,2,233,381,2733,3114,0,2937,177,21,156
CHHATTISGARH,PREPARATION AND ASSEMBLY FOR DACOITY (SECTION 399 TO 402 IPC),0,24,0,0,24,377,401,50,313,38,0,38
GOA,PREPARATION AND ASSEMBLY FOR DACOITY (SECTION 399 TO 402 IPC),0,0,0,0,0,0,0,0,0,0,0,0
GUJARAT,PREPARATION AND ASSEMBLY FOR DACOITY (SECTION 399 TO 402 IPC),0,89,0,10,79,660,739,0,700,39,0,39
HARYANA,PREPARATION AND ASSEMBLY FOR DACOITY (SECTION 399 TO 402 IPC),30,716,0,17,729,2198,2927,0,2291,636,182,454
HIMACHAL PRADESH,PREPARATION AND ASSEMBLY FOR DACOITY (SECTION 399 TO 402 IPC),0,0,0,0,0,0,0,0,0,0,0,0
JAMMU & KASHMIR,PREPARATION AND ASSEMBLY FOR DACOITY (SECTION 399 TO 402 IPC),0,0,0,0,0,0,0,0,0,0,0,0
JHARKHAND,PREPARATION AND ASSEMBLY FOR DACOITY (SECTION 399 TO 402 IPC),180,173,0,174,179,514,693,0,470,223,73,150
KARNATAKA,PREPARATION AND ASSEMBLY FOR DACOITY (SECTION 399 TO 402 IPC),103,2503,71,151,2384,4214,6598,45,5234,1319,10,1309
KERALA,PREPARATION AND ASSEMBLY FOR DACOITY (SECTION 399 TO 402 IPC),99,920,0,65,954,1389,2343,2,1827,514,236,278
MADHYA PRADESH,PREPARATION AND ASSEMBLY FOR DACOITY (SECTION 399 TO 402 IPC),28,632,0,23,637,2208,2845,0,2371,474,122,352
MAHARASHTRA,PREPARATION AND ASSEMBLY FOR DACOITY (SECTION 399 TO 402 IPC),533,1579,0,651,1461,12958,14419,1,13766,652,7,645
MANIPUR,PREPARATION AND ASSEMBLY FOR DACOITY (SECTION 399 TO 402 IPC),280,324,199,403,2,6,8,0,6,2,2,0
MEGHALAYA,PREPARATION AND ASSEMBLY FOR DACOITY (SECTION 399 TO 402 IPC),19,5,0,24,0,27,27,0,27,0,0,0
MIZORAM,PREPARATION AND ASSEMBLY FOR DACOITY (SECTION 399 TO 402 IPC),0,0,0,0,0,0,0,0,0,0,0,0
NAGALAND,PREPARATION AND ASSEMBLY FOR DACOITY (SECTION 399 TO 402 IPC),0,0,0,0,0,0,0,0,0,0,0,0
ODISHA,PREPARATION AND ASSEMBLY FOR DACOITY (SECTION 399 TO 402 IPC),29,641,0,93,577,1159,1736,0,1577,159,15,144
PUNJAB,PREPARATION AND ASSEMBLY FOR DACOITY (SECTION 399 TO 402 IPC),568,902,9,735,726,1514,2240,0,1723,517,167,350
RAJASTHAN,PREPARATION AND ASSEMBLY FOR DACOITY (SECTION 399 TO 402 IPC),0,364,0,14,350,1747,2097,0,1767,330,103,227
SIKKIM,PREPARATION AND ASSEMBLY FOR DACOITY (SECTION 399 TO 402 IPC),0,0,0,0,0,0,0,0,0,0,0,0
TAMIL NADU,PREPARATION AND ASSEMBLY FOR DACOITY (SECTION 399 TO 402 IPC),44,126,0,83,87,274,361,0,296,65,30,35
TRIPURA,PREPARATION AND ASSEMBLY FOR DACOITY (SECTION 399 TO 402 IPC),2,0,2,0,0,3,3,0,2,1,0,1
UTTAR PRADESH,PREPARATION AND ASSEMBLY FOR DACOITY (SECTION 399 TO 402 IPC),28,392,1,23,396,1674,2070,0,1836,234,152,82
UTTARAKHAND,PREPARATION AND ASSEMBLY FOR DACOITY (SECTION 399 TO 402 IPC),0,16,0,0,16,43,59,0,25,34,34,0
WEST BENGAL,PREPARATION AND ASSEMBLY FOR DACOITY (SECTION 399 TO 402 IPC),3641,3139,119,3636,3025,23454,26479,0,25444,1035,30,1005
TOTAL (STATES),PREPARATION AND ASSEMBLY FOR DACOITY (SECTION 399 TO 402 IPC),6010,12886,403,6455,12038,57675,69713,98,63060,6555,1187,5368
A & N ISLANDS,PREPARATION AND ASSEMBLY FOR DACOITY (SECTION 399 TO 402 IPC),0,0,0,0,0,0,0,0,0,0,0,0
CHANDIGARH,PREPARATION AND ASSEMBLY FOR DACOITY (SECTION 399 TO 402 IPC),10,45,0,11,44,42,86,0,76,10,0,10
D & N HAVELI,PREPARATION AND ASSEMBLY FOR DACOITY (SECTION 399 TO 402 IPC),0,0,0,0,0,0,0,0,0,0,0,0
DAMAN & DIU,PREPARATION AND ASSEMBLY FOR DACOITY (SECTION 399 TO 402 IPC),0,0,0,0,0,4,4,0,4,0,0,0
DELHI,PREPARATION AND ASSEMBLY FOR DACOITY (SECTION 399 TO 402 IPC),603,65,3,599,66,2461,2527,0,2184,343,119,224
LAKSHADWEEP,PREPARATION AND ASSEMBLY FOR DACOITY (SECTION 399 TO 402 IPC),0,0,0,0,0,0,0,0,0,0,0,0
PUDUCHERRY,PREPARATION AND ASSEMBLY FOR DACOITY (SECTION 399 TO 402 IPC),35,93,0,38,90,93,183,0,175,8,0,8
TOTAL (UTs),PREPARATION AND ASSEMBLY FOR DACOITY (SECTION 399 TO 402 IPC),648,203,3,648,200,2600,2800,0,2439,361,119,242
TOTAL (ALL-INDIA),PREPARATION AND ASSEMBLY FOR DACOITY (SECTION 399 TO 402 IPC),6658,13089,406,7103,12238,60275,72513,98,65499,6916,1306,5610
ANDHRA PRADESH,"ROBBERY (SECTION 392 TO 394, 397, 398 IPC)",503,1147,0,526,1124,3316,4440,5,3459,976,214,762
ARUNACHAL PRADESH,"ROBBERY (SECTION 392 TO 394, 397, 398 IPC)",78,77,28,79,48,899,947,1,918,28,9,19
ASSAM,"ROBBERY (SECTION 392 TO 394, 397, 398 IPC)",2054,950,463,2023,518,2295,2813,0,2316,497,126,371
BIHAR,"ROBBERY (SECTION 392 TO 394, 397, 398 IPC)",2649,2275,57,2566,2301,26574,28875,0,27528,1347,125,1222
CHHATTISGARH,"ROBBERY (SECTION 392 TO 394, 397, 398 IPC)",101,669,0,91,679,4633,5312,207,4432,673,230,443
GOA,"ROBBERY (SECTION 392 TO 394, 397, 398 IPC)",52,25,2,33,42,224,266,0,248,18,6,12
GUJARAT,"ROBBERY (SECTION 392 TO 394, 397, 398 IPC)",181,1768,4,169,1776,18134,19910,15,19351,544,34,510
HARYANA,"ROBBERY (SECTION 392 TO 394, 397, 398 IPC)",171,1155,0,155,1171,2925,4096,0,3102,994,229,765
HIMACHAL PRADESH,"ROBBERY (SECTION 392 TO 394, 397, 398 IPC)",17,23,0,3,37,230,267,0,238,29,3,26
JAMMU & KASHMIR,"ROBBERY (SECTION 392 TO 394, 397, 398 IPC)",2,114,0,2,114,1830,1944,0,1766,178,10,168
JHARKHAND,"ROBBERY (SECTION 392 TO 394, 397, 398 IPC)",620,668,0,664,624,2282,2906,0,2197,709,180,529
KARNATAKA,"ROBBERY (SECTION 392 TO 394, 397, 398 IPC)",325,2275,66,290,2244,6441,8685,14,7432,1239,122,1117
KERALA,"ROBBERY (SECTION 392 TO 394, 397, 398 IPC)",405,893,6,375,917,5465,6382,4,5719,659,217,442
MADHYA PRADESH,"ROBBERY (SECTION 392 TO 394, 397, 398 IPC)",170,2593,0,70,2693,12629,15322,90,12149,3083,783,2300
MAHARASHTRA,"ROBBERY (SECTION 392 TO 394, 397, 398 IPC)",2172,8041,465,2966,6782,49548,56330,120,52860,3350,434,2916
MANIPUR,"ROBBERY (SECTION 392 TO 394, 397, 398 IPC)",10,0,1,9,0,73,73,0,73,0,0,0
MEGHALAYA,"ROBBERY (SECTION 392 TO 394, 397, 398 IPC)",205,81,21,229,36,692,728,0,725,3,1,2
MIZORAM,"ROBBERY (SECTION 392 TO 394, 397, 398 IPC)",6,5,0,4,7,13,20,1,16,3,2,1
NAGALAND,"ROBBERY (SECTION 392 TO 394, 397, 398 IPC)",49,64,4,35,74,54,128,0,47,81,55,26
ODISHA,"ROBBERY (SECTION 392 TO 394, 397, 398 IPC)",283,2444,0,388,2339,11867,14206,0,12823,1383,192,1191
PUNJAB,"ROBBERY (SECTION 392 TO 394, 397, 398 IPC)",282,467,4,325,420,1216,1636,0,1329,307,107,200
RAJASTHAN,"ROBBERY (SECTION 392 TO 394, 397, 398 IPC)",11,1190,0,25,1176,8516,9692,32,8526,1134,382,752
SIKKIM,"ROBBERY (SECTION 392 TO 394, 397, 398 IPC)",4,9,0,6,7,39,46,2,35,9,3,6
TAMIL NADU,"ROBBERY (SECTION 392 TO 394, 397, 398 IPC)",1217,2380,13,1442,2142,5217,7359,0,6020,1339,717,622
TRIPURA,"ROBBERY (SECTION 392 TO 394, 397, 398 IPC)",20,66,8,10,68,191,259,0,186,73,3,70
UTTAR PRADESH,"ROBBERY (SECTION 392 TO 394, 397, 398 IPC)",796,6195,630,801,5560,19010,24570,9,21454,3107,1649,1458
UTTARAKHAND,"ROBBERY (SECTION 392 TO 394, 397, 398 IPC)",88,235,0,42,281,890,1171,0,953,218,151,67
WEST BENGAL,"ROBBERY (SECTION 392 TO 394, 397, 398 IPC)",1756,1118,163,1757,954,9251,10205,52,9744,409,19,390
TOTAL (STATES),"ROBBERY (SECTION 392 TO 394, 397, 398 IPC)",14227,36927,1935,15085,34134,194454,228588,552,205646,22390,6003,16387
A & N ISLANDS,"ROBBERY (SECTION 392 TO 394, 397, 398 IPC)",1,4,0,4,1,89,90,0,89,1,0,1
CHANDIGARH,"ROBBERY (SECTION 392 TO 394, 397, 398 IPC)",61,120,0,30,151,241,392,0,331,61,26,35
D & N HAVELI,"ROBBERY (SECTION 392 TO 394, 397, 398 IPC)",0,0,0,0,0,29,29,0,28,1,0,1
DAMAN & DIU,"ROBBERY (SECTION 392 TO 394, 397, 398 IPC)",2,4,0,0,6,17,23,0,18,5,2,3
DELHI,"ROBBERY (SECTION 392 TO 394, 397, 398 IPC)",1126,1352,31,1265,1182,5495,6677,0,5615,1062,570,492
LAKSHADWEEP,"ROBBERY (SECTION 392 TO 394, 397, 398 IPC)",0,0,0,0,0,0,0,0,0,0,0,0
PUDUCHERRY,"ROBBERY (SECTION 392 TO 394, 397, 398 IPC)",4,43,0,23,24,76,100,0,100,0,0,0
TOTAL (UTs),"ROBBERY (SECTION 392 TO 394, 397, 398 IPC)",1194,1523,31,1322,1364,5947,7311,0,6181,1130,598,532
TOTAL (ALL-INDIA),"ROBBERY (SECTION 392 TO 394, 397, 398 IPC)",15421,38450,1966,16407,35498,200401,235899,552,211827,23520,6601,16919
ANDHRA PRADESH,"BURGLARY (SECTION 449 TO 452, 454, 455, 457 TO 460 IPC)",2645,6802,0,2866,6581,12753,19334,602,13047,5685,2074,3611
ARUNACHAL PRADESH,"BURGLARY (SECTION 449 TO 452, 454, 455, 457 TO 460 IPC)",82,164,83,59,104,1325,1429,2,1381,46,22,24
ASSAM,"BURGLARY (SECTION 449 TO 452, 454, 455, 457 TO 460 IPC)",4769,3281,2179,4732,1139,4311,5450,0,4446,1004,214,790
BIHAR,"BURGLARY (SECTION 449 TO 452, 454, 455, 457 TO 460 IPC)",3523,2930,516,2582,3355,14383,17738,1,16308,1429,120,1309
CHHATTISGARH,"BURGLARY (SECTION 449 TO 452, 454, 455, 457 TO 460 IPC)",93,2170,0,69,2194,16660,18854,124,16224,2506,573,1933
GOA,"BURGLARY (SECTION 449 TO 452, 454, 455, 457 TO 460 IPC)",125,252,22,204,151,858,1009,0,886,123,17,106
GUJARAT,"BURGLARY (SECTION 449 TO 452, 454, 455, 457 TO 460 IPC)",311,3473,0,294,3490,42416,45906,20,43934,1952,154,1798
HARYANA,"BURGLARY (SECTION 449 TO 452, 454, 455, 457 TO 460 IPC)",698,2679,0,619,2758,13317,16075,0,13132,2943,1019,1924
HIMACHAL PRADESH,"BURGLARY (SECTION 449 TO 452, 454, 455, 457 TO 460 IPC)",160,477,8,91,538,3048,3586,72,3060,454,96,358
JAMMU & KASHMIR,"BURGLARY (SECTION 449 TO 452, 454, 455, 457 TO 460 IPC)",17,811,0,19,809,7080,7889,0,7164,725,63,662
JHARKHAND,"BURGLARY (SECTION 449 TO 452, 454, 455, 457 TO 460 IPC)",659,472,0,398,733,1099,1832,0,1226,606,167,439
KARNATAKA,"BURGLARY (SECTION 449 TO 452, 454, 455, 457 TO 460 IPC)",550,2612,58,417,2687,11946,14633,31,11533,3069,380,2689
KERALA,"BURGLARY (SECTION 449 TO 452, 454, 455, 457 TO 460 IPC)",749,1771,5,643,1872,11377,13249,12,11827,1410,545,865
MADHYA PRADESH,"BURGLARY (SECTION 449 TO 452, 454, 455, 457 TO 460 IPC)",146,6315,0,146,6315,42452,48767,1075,41473,6219,1620,4599
MAHARASHTRA,"BURGLARY (SECTION 449 TO 452, 454, 455, 457 TO 460 IPC)",4546,13301,758,4759,12330,131801,144131,462,135482,8187,1034,7153
MANIPUR,"BURGLARY (SECTION 449 TO 452, 454, 455, 457 TO 460 IPC)",55,10,11,51,3,187,190,1,179,10,6,4
MEGHALAYA,"BURGLARY (SECTION 449 TO 452, 454, 455, 457 TO 460 IPC)",170,81,9,195,47,531,578,0,568,10,8,2
MIZORAM,"BURGLARY (SECTION 449 TO 452, 454, 455, 457 TO 460 IPC)",20,285,0,43,262,201,463,0,216,247,218,29
NAGALAND,"BURGLARY (SECTION 449 TO 452, 454, 455, 457 TO 460 IPC)",31,40,4,10,57,26,83,0,35,48,39,9
ODISHA,"BURGLARY (SECTION 449 TO 452, 454, 455, 457 TO 460 IPC)",423,2844,0,467,2800,22111,24911,0,22359,2552,304,2248
PUNJAB,"BURGLARY (SECTION 449 TO 452, 454, 455, 457 TO 460 IPC)",1129,2265,41,1510,1843,7627,9470,5,7840,1625,749,876
RAJASTHAN,"BURGLARY (SECTION 449 TO 452, 454, 455, 457 TO 460 IPC)",5,3191,0,16,3180,24414,27594,63,24485,3046,1307,1739
SIKKIM,"BURGLARY (SECTION 449 TO 452, 454, 455, 457 TO 460 IPC)",7,50,0,17,40,39,79,0,22,57,34,23
TAMIL NADU,"BURGLARY (SECTION 449 TO 452, 454, 455, 457 TO 460 IPC)",1432,3808,30,1572,3638,9892,13530,0,10909,2621,1407,1214
TRIPURA,"BURGLARY (SECTION 449 TO 452, 454, 455, 457 TO 460 IPC)",56,174,56,57,117,140,257,0,97,160,41,119
UTTAR PRADESH,"BURGLARY (SECTION 449 TO 452, 454, 455, 457 TO 460 IPC)",637,4918,914,603,4038,19678,23716,19,20654,3043,1644,1399
UTTARAKHAND,"BURGLARY (SECTION 449 TO 452, 454, 455, 457 TO 460 IPC)",31,406,5,72,360,1085,1445,8,1178,259,183,76
WEST BENGAL,"BURGLARY (SECTION 449 TO 452, 454, 455, 457 TO 460 IPC)",756,766,344,838,340,3851,4191,0,3982,209,10,199
TOTAL (STATES),"BURGLARY (SECTION 449 TO 452, 454, 455, 457 TO 460 IPC)",23825,66348,5043,23349,61781,404608,466389,2497,413647,50245,14048,36197
A & N ISLANDS,"BURGLARY (SECTION 449 TO 452, 454, 455, 457 TO 460 IPC)",40,40,0,37,43,398,441,0,413,28,12,16
CHANDIGARH,"BURGLARY (SECTION 449 TO 452, 454, 455, 457 TO 460 IPC)",88,171,6,32,221,340,561,0,409,152,112,40
D & N HAVELI,"BURGLARY (SECTION 449 TO 452, 454, 455, 457 TO 460 IPC)",25,25,0,29,21,253,274,0,250,24,0,24
DAMAN & DIU,"BURGLARY (SECTION 449 TO 452, 454, 455, 457 TO 460 IPC)",5,51,2,15,39,64,103,0,99,4,2,2
DELHI,"BURGLARY (SECTION 449 TO 452, 454, 455, 457 TO 460 IPC)",317,1559,254,375,1247,10913,12160,0,10985,1175,584,591
LAKSHADWEEP,"BURGLARY (SECTION 449 TO 452, 454, 455, 457 TO 460 IPC)",1,3,0,4,0,10,10,0,5,5,2,3
PUDUCHERRY,"BURGLARY (SECTION 449 TO 452, 454, 455, 457 TO 460 IPC)",3,68,0,26,45,188,233,0,230,3,3,0
TOTAL (UTs),"BURGLARY (SECTION 449 TO 452, 454, 455, 457 TO 460 IPC)",479,1917,262,518,1616,12166,13782,0,12391,1391,715,676
TOTAL (ALL-INDIA),"BURGLARY (SECTION 449 TO 452, 454, 455, 457 TO 460 IPC)",24304,68265,5305,23867,63397,416774,480171,2497,426038,51636,14763,36873
ANDHRA PRADESH,THEFT (SECTION 379 TO 382 IPC),7110,22106,0,8047,21169,43355,64524,5041,43919,15564,5362,10202
ARUNACHAL PRADESH,THEFT (SECTION 379 TO 382 IPC),224,333,119,258,180,2832,3012,15,2918,79,42,37
ASSAM,THEFT (SECTION 379 TO 382 IPC),10135,9073,6178,9749,3281,11280,14561,23,11818,2720,543,2177
BIHAR,THEFT (SECTION 379 TO 382 IPC),7421,10499,870,7185,9865,71140,81005,8,75190,5807,622,5185
CHHATTISGARH,THEFT (SECTION 379 TO 382 IPC),209,3532,0,138,3603,23049,26652,0,23032,3620,1043,2577
GOA,THEFT (SECTION 379 TO 382 IPC),256,425,63,283,335,1888,2223,24,1981,218,43,175
GUJARAT,THEFT (SECTION 379 TO 382 IPC),1099,8579,0,747,8931,120176,129107,130,123721,5256,542,4714
HARYANA,THEFT (SECTION 379 TO 382 IPC),1917,6124,0,1236,6805,23632,30437,0,23903,6534,2747,3787
HIMACHAL PRADESH,THEFT (SECTION 379 TO 382 IPC),202,747,4,212,733,4689,5422,9,4801,612,104,508
JAMMU & KASHMIR,THEFT (SECTION 379 TO 382 IPC),45,2942,0,54,2933,21089,24022,107,19281,4634,805,3829
JHARKHAND,THEFT (SECTION 379 TO 382 IPC),1699,3488,0,2053,3134,7849,10983,94,7888,3001,779,2222
KARNATAKA,THEFT (SECTION 379 TO 382 IPC),976,6565,189,811,6541,28845,35386,1070,28195,6121,616,5505
KERALA,THEFT (SECTION 379 TO 382 IPC),1069,3326,0,975,3420,21283,24703,96,22112,2495,844,1651
MADHYA PRADESH,THEFT (SECTION 379 TO 382 IPC),136,12095,0,174,12057,72769,84826,3270,71512,10044,3030,7014
MAHARASHTRA,THEFT (SECTION 379 TO 382 IPC),11311,29091,1315,11037,28050,308630,336680,4558,311170,20952,2933,18019
MANIPUR,THEFT (SECTION 379 TO 382 IPC),214,243,200,242,15,364,379,1,363,15,13,2
MEGHALAYA,THEFT (SECTION 379 TO 382 IPC),685,312,74,706,217,1864,2081,15,2004,62,33,29
MIZORAM,THEFT (SECTION 379 TO 382 IPC),70,619,0,155,534,547,1081,2,450,629,591,38
NAGALAND,THEFT (SECTION 379 TO 382 IPC),185,268,43,124,286,173,459,13,115,331,269,62
ODISHA,THEFT (SECTION 379 TO 382 IPC),993,8287,0,1138,8142,61106,69248,0,64165,5083,431,4652
PUNJAB,THEFT (SECTION 379 TO 382 IPC),2033,4689,97,2554,4071,15917,19988,6,16592,3390,1580,1810
RAJASTHAN,THEFT (SECTION 379 TO 382 IPC),53,7944,0,96,7901,51835,59736,594,52173,6969,3478,3491
SIKKIM,THEFT (SECTION 379 TO 382 IPC),34,87,3,50,68,64,132,2,118,12,8,4
TAMIL NADU,THEFT (SECTION 379 TO 382 IPC),5453,11123,116,5916,10544,35081,45625,41,34811,10773,7212,3561
TRIPURA,THEFT (SECTION 379 TO 382 IPC),174,548,77,97,548,653,1201,0,836,365,53,312
UTTAR PRADESH,THEFT (SECTION 379 TO 382 IPC),1656,18291,2234,2196,15517,63440,78957,295,68665,9997,5688,4309
UTTARAKHAND,THEFT (SECTION 379 TO 382 IPC),168,1319,1,198,1288,4863,6151,25,4715,1411,1172,239
WEST BENGAL,THEFT (SECTION 379 TO 382 IPC),17075,15331,5675,19156,7575,65484,73059,239,68168,4652,169,4483
TOTAL (STATES),THEFT (SECTION 379 TO 382 IPC),72602,187986,17258,75587,167743,1063897,1231640,15678,1084616,131346,40752,90594
A & N ISLANDS,THEFT (SECTION 379 TO 382 IPC),35,36,0,23,48,782,830,0,786,44,17,27
CHANDIGARH,THEFT (SECTION 379 TO 382 IPC),259,992,56,150,1045,1643,2688,0,2085,603,473,130
D & N HAVELI,THEFT (SECTION 379 TO 382 IPC),46,105,0,27,124,615,739,0,679,60,9,51
DAMAN & DIU,THEFT (SECTION 379 TO 382 IPC),8,53,0,17,44,93,137,1,123,13,0,13
DELHI,THEFT (SECTION 379 TO 382 IPC),3183,8119,1572,2702,7028,50220,57248,0,49953,7295,3367,3928
LAKSHADWEEP,THEFT (SECTION 379 TO 382 IPC),12,0,0,11,1,7,8,0,6,2,1,1
PUDUCHERRY,THEFT (SECTION 379 TO 382 IPC),23,264,0,61,226,621,847,0,776,71,49,22
TOTAL (UTs),THEFT (SECTION 379 TO 382 IPC),3566,9569,1628,2991,8516,53981,62497,1,54408,8088,3916,4172
TOTAL (ALL-INDIA),THEFT (SECTION 379 TO 382 IPC),76168,197555,18886,78578,176259,1117878,1294137,15679,1139024,139434,44668,94766
ANDHRA PRADESH,AUTO THEFT,1770,4964,0,1651,5083,8612,13695,1123,8407,4165,1742,2423
ARUNACHAL PRADESH,AUTO THEFT,70,85,13,101,41,359,400,0,396,4,3,1
ASSAM,AUTO THEFT,1600,1338,721,1663,554,1323,1877,0,1548,329,86,243
BIHAR,AUTO THEFT,2591,3069,349,2714,2597,8849,11446,0,10532,914,133,781
CHHATTISGARH,AUTO THEFT,34,1043,0,50,1027,3615,4642,0,3772,870,177,693
GOA,AUTO THEFT,54,95,6,35,108,335,443,12,384,47,10,37
GUJARAT,AUTO THEFT,270,3113,0,225,3158,29150,32308,9,30636,1663,237,1426
HARYANA,AUTO THEFT,1133,3403,0,653,3883,11064,14947,0,11752,3195,1488,1707
HIMACHAL PRADESH,AUTO THEFT,46,175,0,56,165,775,940,0,864,76,14,62
JAMMU & KASHMIR,AUTO THEFT,25,260,0,28,257,2474,2731,0,2645,86,8,78
JHARKHAND,AUTO THEFT,486,869,0,440,915,997,1912,7,1098,807,269,538
KARNATAKA,AUTO THEFT,414,2429,73,280,2490,7993,10483,403,8056,2024,189,1835
KERALA,AUTO THEFT,549,840,0,510,879,6135,7014,13,6381,620,216,404
MADHYA PRADESH,AUTO THEFT,36,3926,0,27,3935,14916,18851,572,15451,2828,895,1933
MAHARASHTRA,AUTO THEFT,2761,6428,346,2470,6373,55334,61707,462,58140,3105,575,2530
MANIPUR,AUTO THEFT,47,154,130,63,8,31,39,1,37,1,1,0
MEGHALAYA,AUTO THEFT,44,56,6,52,42,167,209,0,197,12,5,7
MIZORAM,AUTO THEFT,14,23,0,11,26,13,39,0,8,31,31,0
NAGALAND,AUTO THEFT,29,38,2,20,45,37,82,2,18,62,51,11
ODISHA,AUTO THEFT,128,1810,0,199,1739,7193,8932,0,7971,961,103,858
PUNJAB,AUTO THEFT,772,1477,13,924,1312,5880,7192,4,5871,1317,652,665
RAJASTHAN,AUTO THEFT,16,2964,0,32,2948,15647,18595,111,16217,2267,1184,1083
SIKKIM,AUTO THEFT,5,17,0,11,11,2,13,0,4,9,7,2
TAMIL NADU,AUTO THEFT,1030,2562,30,1021,2541,7538,10079,12,8027,2040,1241,799
TRIPURA,AUTO THEFT,8,112,8,5,107,14,121,0,91,30,3,27
UTTAR PRADESH,AUTO THEFT,384,5395,223,549,5007,11555,16562,10,13612,2940,1640,1300
UTTARAKHAND,AUTO THEFT,40,424,0,82,382,965,1347,0,980,367,278,89
WEST BENGAL,AUTO THEFT,3329,2498,969,3761,1097,6805,7902,36,7554,312,11,301
TOTAL (STATES),AUTO THEFT,17685,49567,2889,17633,46730,207778,254508,2777,220649,31082,11249,19833
A & N ISLANDS,AUTO THEFT,10,0,0,6,4,25,29,0,29,0,0,0
CHANDIGARH,AUTO THEFT,127,325,49,35,368,517,885,0,672,213,169,44
D & N HAVELI,AUTO THEFT,8,34,0,4,38,78,116,0,97,19,1,18
DAMAN & DIU,AUTO THEFT,3,26,0,13,16,33,49,1,47,1,0,1
DELHI,AUTO THEFT,1298,3837,849,1121,3165,18910,22075,0,18922,3153,1327,1826
LAKSHADWEEP,AUTO THEFT,0,0,0,0,0,0,0,0,0,0,0,0
PUDUCHERRY,AUTO THEFT,6,88,0,25,69,236,305,0,271,34,22,12
TOTAL (UTs),AUTO THEFT,1452,4310,898,1204,3660,19799,23459,1,20038,3420,1519,1901
TOTAL (ALL-INDIA),AUTO THEFT,19137,53877,3787,18837,50390,227577,277967,2778,240687,34502,12768,21734
ANDHRA PRADESH,OTHER THEFT,5340,17142,0,6396,16086,34743,50829,3918,35512,11399,3620,7779
ARUNACHAL PRADESH,OTHER THEFT,154,248,106,157,139,2473,2612,15,2522,75,39,36
ASSAM,OTHER THEFT,8535,7735,5457,8086,2727,9957,12684,23,10270,2391,457,1934
BIHAR,OTHER THEFT,4830,7430,521,4471,7268,62291,69559,8,64658,4893,489,4404
CHHATTISGARH,OTHER THEFT,175,2489,0,88,2576,19434,22010,0,19260,2750,866,1884
GOA,OTHER THEFT,202,330,57,248,227,1553,1780,12,1597,171,33,138
GUJARAT,OTHER THEFT,829,5466,0,522,5773,91026,96799,121,93085,3593,305,3288
HARYANA,OTHER THEFT,784,2721,0,583,2922,12568,15490,0,12151,3339,1259,2080
HIMACHAL PRADESH,OTHER THEFT,156,572,4,156,568,3914,4482,9,3937,536,90,446
JAMMU & KASHMIR,OTHER THEFT,20,2682,0,26,2676,18615,21291,107,16636,4548,797,3751
JHARKHAND,OTHER THEFT,1213,2619,0,1613,2219,6852,9071,87,6790,2194,510,1684
KARNATAKA,OTHER THEFT,562,4136,116,531,4051,20852,24903,667,20139,4097,427,3670
KERALA,OTHER THEFT,520,2486,0,465,2541,15148,17689,83,15731,1875,628,1247
MADHYA PRADESH,OTHER THEFT,100,8169,0,147,8122,57853,65975,2698,56061,7216,2135,5081
MAHARASHTRA,OTHER THEFT,8550,22663,969,8567,21677,253296,274973,4096,253030,17847,2358,15489
MANIPUR,OTHER THEFT,167,89,70,179,7,333,340,0,326,14,12,2
MEGHALAYA,OTHER THEFT,641,256,68,654,175,1697,1872,15,1807,50,28,22
MIZORAM,OTHER THEFT,56,596,0,144,508,534,1042,2,442,598,560,38
NAGALAND,OTHER THEFT,156,230,41,104,241,136,377,11,97,269,218,51
ODISHA,OTHER THEFT,865,6477,0,939,6403,53913,60316,0,56194,4122,328,3794
PUNJAB,OTHER THEFT,1261,3212,84,1630,2759,10037,12796,2,10721,2073,928,1145
RAJASTHAN,OTHER THEFT,37,4980,0,64,4953,36188,41141,483,35956,4702,2294,2408
SIKKIM,OTHER THEFT,29,70,3,39,57,62,119,2,114,3,1,2
TAMIL NADU,OTHER THEFT,4423,8561,86,4895,8003,27543,35546,29,26784,8733,5971,2762
TRIPURA,OTHER THEFT,166,436,69,92,441,639,1080,0,745,335,50,285
UTTAR PRADESH,OTHER THEFT,1272,12896,2011,1647,10510,51885,62395,285,55053,7057,4048,3009
UTTARAKHAND,OTHER THEFT,128,895,1,116,906,3898,4804,25,3735,1044,894,150
WEST BENGAL,OTHER THEFT,13746,12833,4706,15395,6478,58679,65157,203,60614,4340,158,4182
TOTAL (STATES),OTHER THEFT,54917,138419,14369,57954,121013,856119,977132,12901,863967,100264,29503,70761
A & N ISLANDS,OTHER THEFT,25,36,0,17,44,757,801,0,757,44,17,27
CHANDIGARH,OTHER THEFT,132,667,7,115,677,1126,1803,0,1413,390,304,86
D & N HAVELI,OTHER THEFT,38,71,0,23,86,537,623,0,582,41,8,33
DAMAN & DIU,OTHER THEFT,5,27,0,4,28,60,88,0,76,12,0,12
DELHI,OTHER THEFT,1885,4282,723,1581,3863,31310,35173,0,31031,4142,2040,2102
LAKSHADWEEP,OTHER THEFT,12,0,0,11,1,7,8,0,6,2,1,1
PUDUCHERRY,OTHER THEFT,17,176,0,36,157,385,542,0,505,37,27,10
TOTAL (UTs),OTHER THEFT,2114,5259,730,1787,4856,34182,39038,0,34370,4668,2397,2271
TOTAL (ALL-INDIA),OTHER THEFT,57031,143678,15099,59741,125869,890301,1016170,12901,898337,104932,31900,73032
ANDHRA PRADESH,"RIOTS (SECTION 143, 144, 145, 147, 148, 149, 150, 151, 153, 153A, 153B, 157, 158, 160 IPC)",3430,9441,0,3343,9528,41049,50577,1077,40921,8579,726,7853
ARUNACHAL PRADESH,"RIOTS (SECTION 143, 144, 145, 147, 148, 149, 150, 151, 153, 153A, 153B, 157, 158, 160 IPC)",136,66,18,148,36,1495,1531,0,1527,4,2,2
ASSAM,"RIOTS (SECTION 143, 144, 145, 147, 148, 149, 150, 151, 153, 153A, 153B, 157, 158, 160 IPC)",7769,11426,5371,7340,6484,33380,39864,0,35208,4656,218,4438
BIHAR,"RIOTS (SECTION 143, 144, 145, 147, 148, 149, 150, 151, 153, 153A, 153B, 157, 158, 160 IPC)",26199,45647,846,19915,51085,525153,576238,5863,525865,44510,2530,41980
CHHATTISGARH,"RIOTS (SECTION 143, 144, 145, 147, 148, 149, 150, 151, 153, 153A, 153B, 157, 158, 160 IPC)",765,5720,0,773,5712,39543,45255,5273,36139,3843,1283,2560
GOA,"RIOTS (SECTION 143, 144, 145, 147, 148, 149, 150, 151, 153, 153A, 153B, 157, 158, 160 IPC)",329,462,11,501,279,2412,2691,3,2366,322,46,276
GUJARAT,"RIOTS (SECTION 143, 144, 145, 147, 148, 149, 150, 151, 153, 153A, 153B, 157, 158, 160 IPC)",1477,13040,25,1361,13131,158131,171262,436,165049,5777,227,5550
HARYANA,"RIOTS (SECTION 143, 144, 145, 147, 148, 149, 150, 151, 153, 153A, 153B, 157, 158, 160 IPC)",562,5551,0,487,5626,22984,28610,0,22614,5996,783,5213
HIMACHAL PRADESH,"RIOTS (SECTION 143, 144, 145, 147, 148, 149, 150, 151, 153, 153A, 153B, 157, 158, 160 IPC)",279,2388,3,505,2159,18247,20406,423,17900,2083,178,1905
JAMMU & KASHMIR,"RIOTS (SECTION 143, 144, 145, 147, 148, 149, 150, 151, 153, 153A, 153B, 157, 158, 160 IPC)",31,7461,0,35,7457,47267,54724,2265,46342,6117,225,5892
JHARKHAND,"RIOTS (SECTION 143, 144, 145, 147, 148, 149, 150, 151, 153, 153A, 153B, 157, 158, 160 IPC)",4161,8046,0,4866,7341,18990,26331,300,18565,7466,961,6505
KARNATAKA,"RIOTS (SECTION 143, 144, 145, 147, 148, 149, 150, 151, 153, 153A, 153B, 157, 158, 160 IPC)",5017,28577,672,4753,28169,66896,95065,3281,65020,26764,683,26081
KERALA,"RIOTS (SECTION 143, 144, 145, 147, 148, 149, 150, 151, 153, 153A, 153B, 157, 158, 160 IPC)",9708,46126,0,8787,47047,181219,228266,1706,197980,28580,6569,22011
MADHYA PRADESH,"RIOTS (SECTION 143, 144, 145, 147, 148, 149, 150, 151, 153, 153A, 153B, 157, 158, 160 IPC)",375,13290,0,271,13394,128292,141686,3641,127166,10879,3556,7323
MAHARASHTRA,"RIOTS (SECTION 143, 144, 145, 147, 148, 149, 150, 151, 153, 153A, 153B, 157, 158, 160 IPC)",18570,57218,64,19323,56401,585851,642252,7858,593515,40879,1207,39672
MANIPUR,"RIOTS (SECTION 143, 144, 145, 147, 148, 149, 150, 151, 153, 153A, 153B, 157, 158, 160 IPC)",85,21,25,80,1,229,230,0,230,0,0,0
MEGHALAYA,"RIOTS (SECTION 143, 144, 145, 147, 148, 149, 150, 151, 153, 153A, 153B, 157, 158, 160 IPC)",83,0,5,78,0,681,681,2,679,0,0,0
MIZORAM,"RIOTS (SECTION 143, 144, 145, 147, 148, 149, 150, 151, 153, 153A, 153B, 157, 158, 160 IPC)",0,0,0,0,0,0,0,0,0,0,0,0
NAGALAND,"RIOTS (SECTION 143, 144, 145, 147, 148, 149, 150, 151, 153, 153A, 153B, 157, 158, 160 IPC)",0,30,0,2,28,0,28,0,28,0,0,0
ODISHA,"RIOTS (SECTION 143, 144, 145, 147, 148, 149, 150, 151, 153, 153A, 153B, 157, 158, 160 IPC)",1517,12336,125,1677,12051,78947,90998,0,84251,6747,335,6412
PUNJAB,"RIOTS (SECTION 143, 144, 145, 147, 148, 149, 150, 151, 153, 153A, 153B, 157, 158, 160 IPC)",3,0,0,3,0,34,34,0,27,7,7,0
RAJASTHAN,"RIOTS (SECTION 143, 144, 145, 147, 148, 149, 150, 151, 153, 153A, 153B, 157, 158, 160 IPC)",92,3030,0,92,3030,89152,92182,1389,82197,8596,5394,3202
SIKKIM,"RIOTS (SECTION 143, 144, 145, 147, 148, 149, 150, 151, 153, 153A, 153B, 157, 158, 160 IPC)",17,95,35,50,27,46,73,0,22,51,15,36
TAMIL NADU,"RIOTS (SECTION 143, 144, 145, 147, 148, 149, 150, 151, 153, 153A, 153B, 157, 158, 160 IPC)",9364,16725,305,7892,17892,42266,60158,7,46531,13620,2285,11335
TRIPURA,"RIOTS (SECTION 143, 144, 145, 147, 148, 149, 150, 151, 153, 153A, 153B, 157, 158, 160 IPC)",215,297,41,98,373,190,563,0,305,258,34,224
UTTAR PRADESH,"RIOTS (SECTION 143, 144, 145, 147, 148, 149, 150, 151, 153, 153A, 153B, 157, 158, 160 IPC)",5828,43526,8477,6236,34641,118872,153513,2704,130739,20070,10222,9848
UTTARAKHAND,"RIOTS (SECTION 143, 144, 145, 147, 148, 149, 150, 151, 153, 153A, 153B, 157, 158, 160 IPC)",460,1440,63,297,1540,9246,10786,746,7745,2295,1184,1111
WEST BENGAL,"RIOTS (SECTION 143, 144, 145, 147, 148, 149, 150, 151, 153, 153A, 153B, 157, 158, 160 IPC)",8779,14448,2424,5653,15150,218206,233356,733,221393,11230,229,11001
TOTAL (STATES),"RIOTS (SECTION 143, 144, 145, 147, 148, 149, 150, 151, 153, 153A, 153B, 157, 158, 160 IPC)",105251,346407,18510,94566,338582,2428778,2767360,37707,2470324,259329,38899,220430
A & N ISLANDS,"RIOTS (SECTION 143, 144, 145, 147, 148, 149, 150, 151, 153, 153A, 153B, 157, 158, 160 IPC)",29,52,0,23,58,853,911,0,888,23,0,23
CHANDIGARH,"RIOTS (SECTION 143, 144, 145, 147, 148, 149, 150, 151, 153, 153A, 153B, 157, 158, 160 IPC)",234,200,1,63,370,1174,1544,0,1344,200,23,177
D & N HAVELI,"RIOTS (SECTION 143, 144, 145, 147, 148, 149, 150, 151, 153, 153A, 153B, 157, 158, 160 IPC)",66,85,0,57,94,1144,1238,0,1090,148,12,136
DAMAN & DIU,"RIOTS (SECTION 143, 144, 145, 147, 148, 149, 150, 151, 153, 153A, 153B, 157, 158, 160 IPC)",67,95,0,31,131,487,618,6,560,52,5,47
DELHI,"RIOTS (SECTION 143, 144, 145, 147, 148, 149, 150, 151, 153, 153A, 153B, 157, 158, 160 IPC)",107,388,16,102,377,16919,17296,0,16936,360,193,167
LAKSHADWEEP,"RIOTS (SECTION 143, 144, 145, 147, 148, 149, 150, 151, 153, 153A, 153B, 157, 158, 160 IPC)",70,0,0,68,2,52,54,0,26,28,14,14
PUDUCHERRY,"RIOTS (SECTION 143, 144, 145, 147, 148, 149, 150, 151, 153, 153A, 153B, 157, 158, 160 IPC)",176,1005,0,416,765,2488,3253,7,2945,301,159,142
TOTAL (UTs),"RIOTS (SECTION 143, 144, 145, 147, 148, 149, 150, 151, 153, 153A, 153B, 157, 158, 160 IPC)",749,1825,17,760,1797,23117,24914,13,23789,1112,406,706
TOTAL (ALL-INDIA),"RIOTS (SECTION 143, 144, 145, 147, 148, 149, 150, 151, 153, 153A, 153B, 157, 158, 160 IPC)",106000,348232,18527,95326,340379,2451895,2792274,37720,2494113,260441,39305,221136
ANDHRA PRADESH,CRIMINAL BREACH OF TRUST (SECTION 406 TO 409 IPC),816,998,0,796,1018,3465,4483,121,3629,733,80,653
ARUNACHAL PRADESH,CRIMINAL BREACH OF TRUST (SECTION 406 TO 409 IPC),36,39,5,40,30,341,371,1,365,5,1,4
ASSAM,CRIMINAL BREACH OF TRUST (SECTION 406 TO 409 IPC),1255,931,433,1343,410,1518,1928,0,1673,255,35,220
BIHAR,CRIMINAL BREACH OF TRUST (SECTION 406 TO 409 IPC),2332,2403,202,2163,2370,13361,15731,35,14677,1019,73,946
CHHATTISGARH,CRIMINAL BREACH OF TRUST (SECTION 406 TO 409 IPC),16,191,0,14,193,1345,1538,0,1374,164,55,109
GOA,CRIMINAL BREACH OF TRUST (SECTION 406 TO 409 IPC),76,34,7,96,7,240,247,0,243,4,0,4
GUJARAT,CRIMINAL BREACH OF TRUST (SECTION 406 TO 409 IPC),507,2324,0,532,2299,26817,29116,17,27933,1166,107,1059
HARYANA,CRIMINAL BREACH OF TRUST (SECTION 406 TO 409 IPC),210,564,0,84,690,2766,3456,0,2775,681,143,538
HIMACHAL PRADESH,CRIMINAL BREACH OF TRUST (SECTION 406 TO 409 IPC),54,100,4,56,94,797,891,8,799,84,10,74
JAMMU & KASHMIR,CRIMINAL BREACH OF TRUST (SECTION 406 TO 409 IPC),11,249,0,12,248,1656,1904,14,1686,204,11,193
JHARKHAND,CRIMINAL BREACH OF TRUST (SECTION 406 TO 409 IPC),190,694,0,325,559,1212,1771,6,1258,507,119,388
KARNATAKA,CRIMINAL BREACH OF TRUST (SECTION 406 TO 409 IPC),186,420,6,230,370,2602,2972,27,2599,346,27,319
KERALA,CRIMINAL BREACH OF TRUST (SECTION 406 TO 409 IPC),161,245,0,172,234,2181,2415,3,2177,235,29,206
MADHYA PRADESH,CRIMINAL BREACH OF TRUST (SECTION 406 TO 409 IPC),33,777,0,50,760,4535,5295,56,4699,540,225,315
MAHARASHTRA,CRIMINAL BREACH OF TRUST (SECTION 406 TO 409 IPC),1750,2574,39,1794,2491,34225,36716,104,35106,1506,88,1418
MANIPUR,CRIMINAL BREACH OF TRUST (SECTION 406 TO 409 IPC),36,17,14,38,1,53,54,0,53,1,1,0
MEGHALAYA,CRIMINAL BREACH OF TRUST (SECTION 406 TO 409 IPC),40,28,12,33,23,147,170,0,170,0,0,0
MIZORAM,CRIMINAL BREACH OF TRUST (SECTION 406 TO 409 IPC),3,14,0,5,12,16,28,0,9,19,15,4
NAGALAND,CRIMINAL BREACH OF TRUST (SECTION 406 TO 409 IPC),10,19,2,9,18,19,37,0,14,23,17,6
ODISHA,CRIMINAL BREACH OF TRUST (SECTION 406 TO 409 IPC),59,453,0,69,443,3042,3485,0,3057,428,29,399
PUNJAB,CRIMINAL BREACH OF TRUST (SECTION 406 TO 409 IPC),337,361,25,356,317,1851,2168,2,1902,264,70,194
RAJASTHAN,CRIMINAL BREACH OF TRUST (SECTION 406 TO 409 IPC),3,325,0,8,320,2924,3244,33,2984,227,83,144
SIKKIM,CRIMINAL BREACH OF TRUST (SECTION 406 TO 409 IPC),8,3,0,8,3,10,13,0,8,5,1,4
TAMIL NADU,CRIMINAL BREACH OF TRUST (SECTION 406 TO 409 IPC),249,375,6,411,207,700,907,0,754,153,34,119
TRIPURA,CRIMINAL BREACH OF TRUST (SECTION 406 TO 409 IPC),17,54,14,3,54,93,147,0,137,10,2,8
UTTAR PRADESH,CRIMINAL BREACH OF TRUST (SECTION 406 TO 409 IPC),1835,7132,2807,2040,4120,14872,18992,272,16343,2377,1168,1209
UTTARAKHAND,CRIMINAL BREACH OF TRUST (SECTION 406 TO 409 IPC),34,63,2,33,62,601,663,1,525,137,112,25
WEST BENGAL,CRIMINAL BREACH OF TRUST (SECTION 406 TO 409 IPC),882,1509,370,846,1175,5274,6449,115,5946,388,12,376
TOTAL (STATES),CRIMINAL BREACH OF TRUST (SECTION 406 TO 409 IPC),11146,22896,3948,11566,18528,126663,145191,815,132895,11481,2547,8934
A & N ISLANDS,CRIMINAL BREACH OF TRUST (SECTION 406 TO 409 IPC),12,5,0,11,6,36,42,0,36,6,0,6
CHANDIGARH,CRIMINAL BREACH OF TRUST (SECTION 406 TO 409 IPC),27,38,8,11,46,134,180,0,165,15,7,8
D & N HAVELI,CRIMINAL BREACH OF TRUST (SECTION 406 TO 409 IPC),15,22,0,23,14,167,181,0,176,5,0,5
DAMAN & DIU,CRIMINAL BREACH OF TRUST (SECTION 406 TO 409 IPC),3,6,1,1,7,28,35,1,34,0,0,0
DELHI,CRIMINAL BREACH OF TRUST (SECTION 406 TO 409 IPC),83,222,6,68,231,1539,1770,0,1504,266,84,182
LAKSHADWEEP,CRIMINAL BREACH OF TRUST (SECTION 406 TO 409 IPC),0,0,0,0,0,0,0,0,0,0,0,0
PUDUCHERRY,CRIMINAL BREACH OF TRUST (SECTION 406 TO 409 IPC),1,4,0,4,1,69,70,0,69,1,0,1
TOTAL (UTs),CRIMINAL BREACH OF TRUST (SECTION 406 TO 409 IPC),141,297,15,118,305,1973,2278,1,1984,293,91,202
TOTAL (ALL-INDIA),CRIMINAL BREACH OF TRUST (SECTION 406 TO 409 IPC),11287,23193,3963,11684,18833,128636,147469,816,134879,11774,2638,9136
ANDHRA PRADESH,CHEATING (SECTION 419 TO 420 IPC),3944,8836,0,4413,8367,22938,31305,2011,24037,5257,777,4480
ARUNACHAL PRADESH,CHEATING (SECTION 419 TO 420 IPC),81,61,23,83,36,288,324,1,309,14,5,9
ASSAM,CHEATING (SECTION 419 TO 420 IPC),1524,1659,799,1524,860,2213,3073,50,2328,695,63,632
BIHAR,CHEATING (SECTION 419 TO 420 IPC),5445,5001,125,4685,5636,19728,25364,291,23321,1752,140,1612
CHHATTISGARH,CHEATING (SECTION 419 TO 420 IPC),274,1010,0,314,970,4974,5944,339,4968,637,292,345
GOA,CHEATING (SECTION 419 TO 420 IPC),253,121,8,337,29,610,639,2,596,41,2,39
GUJARAT,CHEATING (SECTION 419 TO 420 IPC),525,2368,4,452,2437,31393,33830,16,32849,965,118,847
HARYANA,CHEATING (SECTION 419 TO 420 IPC),448,1558,0,339,1667,7140,8807,0,7107,1700,327,1373
HIMACHAL PRADESH,CHEATING (SECTION 419 TO 420 IPC),129,239,11,122,235,1470,1705,5,1608,92,10,82
JAMMU & KASHMIR,CHEATING (SECTION 419 TO 420 IPC),16,852,0,18,850,4572,5422,79,4709,634,62,572
JHARKHAND,CHEATING (SECTION 419 TO 420 IPC),545,1489,0,699,1335,1605,2940,20,1918,1002,233,769
KARNATAKA,CHEATING (SECTION 419 TO 420 IPC),1627,5638,173,1517,5575,12449,18024,258,14398,3368,141,3227
KERALA,CHEATING (SECTION 419 TO 420 IPC),1232,3474,0,1268,3438,15583,19021,130,16944,1947,258,1689
MADHYA PRADESH,CHEATING (SECTION 419 TO 420 IPC),180,2930,0,257,2853,15492,18345,342,16214,1789,589,1200
MAHARASHTRA,CHEATING (SECTION 419 TO 420 IPC),6267,10938,137,6444,10624,86293,96917,369,92481,4067,311,3756
MANIPUR,CHEATING (SECTION 419 TO 420 IPC),128,63,61,128,2,64,66,0,62,4,3,1
MEGHALAYA,CHEATING (SECTION 419 TO 420 IPC),215,69,18,200,66,272,338,3,331,4,0,4
MIZORAM,CHEATING (SECTION 419 TO 420 IPC),11,29,0,17,23,45,68,0,32,36,32,4
NAGALAND,CHEATING (SECTION 419 TO 420 IPC),29,45,2,33,39,42,81,0,36,45,39,6
ODISHA,CHEATING (SECTION 419 TO 420 IPC),149,1580,7,183,1539,8066,9605,0,8698,907,117,790
PUNJAB,CHEATING (SECTION 419 TO 420 IPC),2122,4187,204,2738,3367,21845,25212,9,21743,3460,943,2517
RAJASTHAN,CHEATING (SECTION 419 TO 420 IPC),135,5897,5,174,5853,28705,34558,617,31551,2390,1134,1256
SIKKIM,CHEATING (SECTION 419 TO 420 IPC),25,14,0,27,12,77,89,0,64,25,8,17
TAMIL NADU,CHEATING (SECTION 419 TO 420 IPC),3843,4677,147,5546,2827,7370,10197,0,8411,1786,407,1379
TRIPURA,CHEATING (SECTION 419 TO 420 IPC),49,46,6,10,79,84,163,0,78,85,6,79
UTTAR PRADESH,CHEATING (SECTION 419 TO 420 IPC),7558,30437,12755,10558,14682,34027,48709,207,41900,6602,3177,3425
UTTARAKHAND,CHEATING (SECTION 419 TO 420 IPC),250,449,10,293,396,2685,3081,49,2847,185,108,77
WEST BENGAL,CHEATING (SECTION 419 TO 420 IPC),3008,4818,1477,3201,3148,9735,12883,73,11752,1058,45,1013
TOTAL (STATES),CHEATING (SECTION 419 TO 420 IPC),40012,98485,15972,45580,76945,339765,416710,4871,371292,40547,9347,31200
A & N ISLANDS,CHEATING (SECTION 419 TO 420 IPC),33,26,0,37,22,202,224,0,219,5,0,5
CHANDIGARH,CHEATING (SECTION 419 TO 420 IPC),224,246,24,162,284,1201,1485,0,1359,126,40,86
D & N HAVELI,CHEATING (SECTION 419 TO 420 IPC),32,12,0,14,30,129,159,0,157,2,0,2
DAMAN & DIU,CHEATING (SECTION 419 TO 420 IPC),13,14,0,6,21,49,70,0,69,1,0,1
DELHI,CHEATING (SECTION 419 TO 420 IPC),653,1754,69,661,1677,16172,17849,0,14384,3465,2660,805
LAKSHADWEEP,CHEATING (SECTION 419 TO 420 IPC),0,0,0,0,0,0,0,0,0,0,0,0
PUDUCHERRY,CHEATING (SECTION 419 TO 420 IPC),49,89,0,110,28,235,263,0,239,24,2,22
TOTAL (UTs),CHEATING (SECTION 419 TO 420 IPC),1004,2141,93,990,2062,17988,20050,0,16427,3623,2702,921
TOTAL (ALL-INDIA),CHEATING (SECTION 419 TO 420 IPC),41016,100626,16065,46570,79007,357753,436760,4871,387719,44170,12049,32121
ANDHRA PRADESH,COUNTERFEITING (SECTION 231-254 AND 489A TO 489D IPC),250,266,0,273,243,740,983,0,781,202,27,175
ARUNACHAL PRADESH,COUNTERFEITING (SECTION 231-254 AND 489A TO 489D IPC),2,0,1,0,1,46,47,0,47,0,0,0
ASSAM,COUNTERFEITING (SECTION 231-254 AND 489A TO 489D IPC),283,86,36,228,105,449,554,0,504,50,6,44
BIHAR,COUNTERFEITING (SECTION 231-254 AND 489A TO 489D IPC),93,105,1,78,119,768,887,0,821,66,12,54
CHHATTISGARH,COUNTERFEITING (SECTION 231-254 AND 489A TO 489D IPC),3,34,0,6,31,254,285,32,208,45,25,20
GOA,COUNTERFEITING (SECTION 231-254 AND 489A TO 489D IPC),2,4,0,5,1,21,22,0,20,2,0,2
GUJARAT,COUNTERFEITING (SECTION 231-254 AND 489A TO 489D IPC),14,133,0,9,138,981,1119,0,1091,28,7,21
HARYANA,COUNTERFEITING (SECTION 231-254 AND 489A TO 489D IPC),3,35,0,0,38,191,229,0,177,52,18,34
HIMACHAL PRADESH,COUNTERFEITING (SECTION 231-254 AND 489A TO 489D IPC),0,3,0,0,3,31,34,0,24,10,1,9
JAMMU & KASHMIR,COUNTERFEITING (SECTION 231-254 AND 489A TO 489D IPC),4,69,0,4,69,295,364,0,315,49,3,46
JHARKHAND,COUNTERFEITING (SECTION 231-254 AND 489A TO 489D IPC),22,28,0,10,40,130,170,0,118,52,5,47
KARNATAKA,COUNTERFEITING (SECTION 231-254 AND 489A TO 489D IPC),13,84,1,10,86,577,663,6,569,88,7,81
KERALA,COUNTERFEITING (SECTION 231-254 AND 489A TO 489D IPC),42,485,10,360,157,831,988,0,978,10,8,2
MADHYA PRADESH,COUNTERFEITING (SECTION 231-254 AND 489A TO 489D IPC),1,55,0,0,56,268,324,0,297,27,11,16
MAHARASHTRA,COUNTERFEITING (SECTION 231-254 AND 489A TO 489D IPC),173,266,6,206,227,1830,2057,1,1945,111,20,91
MANIPUR,COUNTERFEITING (SECTION 231-254 AND 489A TO 489D IPC),29,1,0,26,4,133,137,0,137,0,0,0
MEGHALAYA,COUNTERFEITING (SECTION 231-254 AND 489A TO 489D IPC),49,11,1,46,13,64,77,0,75,2,2,0
MIZORAM,COUNTERFEITING (SECTION 231-254 AND 489A TO 489D IPC),1,5,0,1,5,1,6,0,4,2,2,0
NAGALAND,COUNTERFEITING (SECTION 231-254 AND 489A TO 489D IPC),4,7,1,5,5,5,10,0,8,2,1,1
ODISHA,COUNTERFEITING (SECTION 231-254 AND 489A TO 489D IPC),0,24,0,0,24,457,481,0,449,32,4,28
PUNJAB,COUNTERFEITING (SECTION 231-254 AND 489A TO 489D IPC),113,92,0,108,97,449,546,0,435,111,72,39
RAJASTHAN,COUNTERFEITING (SECTION 231-254 AND 489A TO 489D IPC),1,64,0,2,63,549,612,0,569,43,15,28
SIKKIM,COUNTERFEITING (SECTION 231-254 AND 489A TO 489D IPC),5,2,0,4,3,1,4,0,2,2,2,0
TAMIL NADU,COUNTERFEITING (SECTION 231-254 AND 489A TO 489D IPC),237,98,2,266,67,309,376,0,307,69,11,58
TRIPURA,COUNTERFEITING (SECTION 231-254 AND 489A TO 489D IPC),8,14,0,8,14,43,57,0,47,10,0,10
UTTAR PRADESH,COUNTERFEITING (SECTION 231-254 AND 489A TO 489D IPC),84,199,11,60,212,1364,1576,0,1391,185,118,67
UTTARAKHAND,COUNTERFEITING (SECTION 231-254 AND 489A TO 489D IPC),2,26,0,5,23,105,128,0,116,12,7,5
WEST BENGAL,COUNTERFEITING (SECTION 231-254 AND 489A TO 489D IPC),395,534,37,429,463,1141,1604,0,1460,144,54,90
TOTAL (STATES),COUNTERFEITING (SECTION 231-254 AND 489A TO 489D IPC),1833,2730,107,2149,2307,12033,14340,39,12895,1406,438,968
A & N ISLANDS,COUNTERFEITING (SECTION 231-254 AND 489A TO 489D IPC),0,0,0,0,0,3,3,0,3,0,0,0
CHANDIGARH,COUNTERFEITING (SECTION 231-254 AND 489A TO 489D IPC),1,2,0,0,3,12,15,0,7,8,8,0
D & N HAVELI,COUNTERFEITING (SECTION 231-254 AND 489A TO 489D IPC),0,0,0,0,0,0,0,0,0,0,0,0
DAMAN & DIU,COUNTERFEITING (SECTION 231-254 AND 489A TO 489D IPC),0,0,0,0,0,0,0,0,0,0,0,0
DELHI,COUNTERFEITING (SECTION 231-254 AND 489A TO 489D IPC),31,76,0,55,52,485,537,0,487,50,22,28
LAKSHADWEEP,COUNTERFEITING (SECTION 231-254 AND 489A TO 489D IPC),0,0,0,0,0,0,0,0,0,0,0,0
PUDUCHERRY,COUNTERFEITING (SECTION 231-254 AND 489A TO 489D IPC),0,6,0,6,0,6,6,0,6,0,0,0
TOTAL (UTs),COUNTERFEITING (SECTION 231-254 AND 489A TO 489D IPC),32,84,0,61,55,506,561,0,503,58,30,28
TOTAL (ALL-INDIA),COUNTERFEITING (SECTION 231-254 AND 489A TO 489D IPC),1865,2814,107,2210,2362,12539,14901,39,13398,1464,468,996
ANDHRA PRADESH,"ARSON (SECTION 435, 436, 438 IPC)",349,1042,0,411,980,1880,2860,89,1878,893,55,838
ARUNACHAL PRADESH,"ARSON (SECTION 435, 436, 438 IPC)",8,23,12,9,10,122,132,0,124,8,1,7
ASSAM,"ARSON (SECTION 435, 436, 438 IPC)",1273,825,431,1214,453,1468,1921,0,1674,247,13,234
BIHAR,"ARSON (SECTION 435, 436, 438 IPC)",806,1736,52,807,1683,5178,6861,165,5821,875,78,797
CHHATTISGARH,"ARSON (SECTION 435, 436, 438 IPC)",28,264,0,0,292,1072,1364,0,1036,328,104,224
GOA,"ARSON (SECTION 435, 436, 438 IPC)",24,38,1,39,22,233,255,0,197,58,2,56
GUJARAT,"ARSON (SECTION 435, 436, 438 IPC)",30,484,0,55,459,9655,10114,11,9654,449,22,427
HARYANA,"ARSON (SECTION 435, 436, 438 IPC)",31,251,0,22,260,1400,1660,0,1427,233,28,205
HIMACHAL PRADESH,"ARSON (SECTION 435, 436, 438 IPC)",22,91,0,19,94,702,796,1,698,97,10,87
JAMMU & KASHMIR,"ARSON (SECTION 435, 436, 438 IPC)",6,278,0,7,277,1976,2253,12,2107,134,10,124
JHARKHAND,"ARSON (SECTION 435, 436, 438 IPC)",174,151,1,178,146,326,472,6,294,172,48,124
KARNATAKA,"ARSON (SECTION 435, 436, 438 IPC)",27,236,1,41,221,1071,1292,13,824,455,11,444
KERALA,"ARSON (SECTION 435, 436, 438 IPC)",140,466,0,196,410,1485,1895,7,1648,240,23,217
MADHYA PRADESH,"ARSON (SECTION 435, 436, 438 IPC)",10,1205,0,24,1191,4974,6165,85,4873,1207,254,953
MAHARASHTRA,"ARSON (SECTION 435, 436, 438 IPC)",473,1625,6,639,1453,15593,17046,77,15807,1162,38,1124
MANIPUR,"ARSON (SECTION 435, 436, 438 IPC)",11,9,0,20,0,4,4,0,4,0,0,0
MEGHALAYA,"ARSON (SECTION 435, 436, 438 IPC)",64,42,7,72,27,124,151,0,146,5,0,5
MIZORAM,"ARSON (SECTION 435, 436, 438 IPC)",1,11,0,0,12,16,28,0,18,10,9,1
NAGALAND,"ARSON (SECTION 435, 436, 438 IPC)",0,3,0,2,1,3,4,0,3,1,1,0
ODISHA,"ARSON (SECTION 435, 436, 438 IPC)",105,680,10,74,701,3182,3883,0,3372,511,41,470
PUNJAB,"ARSON (SECTION 435, 436, 438 IPC)",119,101,3,147,70,375,445,0,366,79,38,41
RAJASTHAN,"ARSON (SECTION 435, 436, 438 IPC)",10,603,0,8,605,4403,5008,77,4292,639,248,391
SIKKIM,"ARSON (SECTION 435, 436, 438 IPC)",2,5,0,4,3,2,5,0,3,2,0,2
TAMIL NADU,"ARSON (SECTION 435, 436, 438 IPC)",569,785,33,663,658,1529,2187,0,1666,521,120,401
TRIPURA,"ARSON (SECTION 435, 436, 438 IPC)",9,46,12,3,40,35,75,0,36,39,3,36
UTTAR PRADESH,"ARSON (SECTION 435, 436, 438 IPC)",175,856,305,42,684,3157,3841,10,3322,509,226,283
UTTARAKHAND,"ARSON (SECTION 435, 436, 438 IPC)",0,12,1,0,11,76,87,0,81,6,3,3
WEST BENGAL,"ARSON (SECTION 435, 436, 438 IPC)",238,597,33,303,499,1557,2056,2,1810,244,8,236
TOTAL (STATES),"ARSON (SECTION 435, 436, 438 IPC)",4704,12465,908,4999,11262,61598,72860,555,63181,9124,1394,7730
A & N ISLANDS,"ARSON (SECTION 435, 436, 438 IPC)",9,6,0,9,6,54,60,0,59,1,0,1
CHANDIGARH,"ARSON (SECTION 435, 436, 438 IPC)",6,5,0,6,5,17,22,0,21,1,0,1
D & N HAVELI,"ARSON (SECTION 435, 436, 438 IPC)",2,2,0,2,2,16,18,0,18,0,0,0
DAMAN & DIU,"ARSON (SECTION 435, 436, 438 IPC)",0,7,0,0,7,13,20,2,14,4,0,4
DELHI,"ARSON (SECTION 435, 436, 438 IPC)",22,47,0,36,33,106,139,0,130,9,1,8
LAKSHADWEEP,"ARSON (SECTION 435, 436, 438 IPC)",35,0,27,8,0,0,0,0,0,0,0,0
PUDUCHERRY,"ARSON (SECTION 435, 436, 438 IPC)",2,40,0,34,8,26,34,0,23,11,4,7
TOTAL (UTs),"ARSON (SECTION 435, 436, 438 IPC)",76,107,27,95,61,232,293,2,265,26,5,21
TOTAL (ALL-INDIA),"ARSON (SECTION 435, 436, 438 IPC)",4780,12572,935,5094,11323,61830,73153,557,63446,9150,1399,7751
ANDHRA PRADESH,"HURT (SECTION 323, 324 TO 333, 335 TO 338 IPC)",15272,74884,0,17095,73061,114935,187996,17339,117596,53061,15874,37187
ARUNACHAL PRADESH,"HURT (SECTION 323, 324 TO 333, 335 TO 338 IPC)",466,496,76,578,308,3031,3339,45,3183,111,45,66
ASSAM,"HURT (SECTION 323, 324 TO 333, 335 TO 338 IPC)",7598,7795,3651,6597,5145,13131,18276,99,13796,4381,449,3932
BIHAR,"HURT (SECTION 323, 324 TO 333, 335 TO 338 IPC)",10884,82097,955,11357,80669,118043,198712,6630,168567,23515,3207,20308
CHHATTISGARH,"HURT (SECTION 323, 324 TO 333, 335 TO 338 IPC)",446,19947,0,350,20043,47221,67264,5303,50651,11310,4144,7166
GOA,"HURT (SECTION 323, 324 TO 333, 335 TO 338 IPC)",179,381,7,301,252,1447,1699,9,1446,244,36,208
GUJARAT,"HURT (SECTION 323, 324 TO 333, 335 TO 338 IPC)",1548,23206,0,1940,22814,263773,286587,702,271074,14811,723,14088
HARYANA,"HURT (SECTION 323, 324 TO 333, 335 TO 338 IPC)",930,7513,0,612,7831,49968,57799,164,46735,10900,2012,8888
HIMACHAL PRADESH,"HURT (SECTION 323, 324 TO 333, 335 TO 338 IPC)",392,1566,5,339,1614,9864,11478,393,9636,1449,224,1225
JAMMU & KASHMIR,"HURT (SECTION 323, 324 TO 333, 335 TO 338 IPC)",5,678,0,6,677,2106,2783,415,1962,406,40,366
JHARKHAND,"HURT (SECTION 323, 324 TO 333, 335 TO 338 IPC)",3416,8783,2,4867,7330,6864,14194,778,8594,4822,1360,3462
KARNATAKA,"HURT (SECTION 323, 324 TO 333, 335 TO 338 IPC)",3687,33469,913,4233,32010,56712,88722,4068,60085,24569,902,23667
KERALA,"HURT (SECTION 323, 324 TO 333, 335 TO 338 IPC)",6056,29634,0,5227,30463,115434,145897,2527,124340,19030,2236,16794
MADHYA PRADESH,"HURT (SECTION 323, 324 TO 333, 335 TO 338 IPC)",225,72369,0,187,72407,235064,307471,26323,239407,41741,18182,23559
MAHARASHTRA,"HURT (SECTION 323, 324 TO 333, 335 TO 338 IPC)",15190,58180,25,16335,57010,537309,594319,8137,543366,42816,1959,40857
MANIPUR,"HURT (SECTION 323, 324 TO 333, 335 TO 338 IPC)",185,142,144,179,4,56,60,0,57,3,2,1
MEGHALAYA,"HURT (SECTION 323, 324 TO 333, 335 TO 338 IPC)",144,127,16,137,118,882,1000,0,934,66,7,59
MIZORAM,"HURT (SECTION 323, 324 TO 333, 335 TO 338 IPC)",29,123,0,38,114,116,230,1,135,94,79,15
NAGALAND,"HURT (SECTION 323, 324 TO 333, 335 TO 338 IPC)",22,21,5,14,24,36,60,2,23,35,28,7
ODISHA,"HURT (SECTION 323, 324 TO 333, 335 TO 338 IPC)",719,11588,5,633,11669,63523,75192,0,66067,9125,561,8564
PUNJAB,"HURT (SECTION 323, 324 TO 333, 335 TO 338 IPC)",5633,8460,404,6780,6909,26887,33796,7,25390,8399,2337,6062
RAJASTHAN,"HURT (SECTION 323, 324 TO 333, 335 TO 338 IPC)",17,30861,0,6,30872,129873,160745,11799,124370,24576,15958,8618
SIKKIM,"HURT (SECTION 323, 324 TO 333, 335 TO 338 IPC)",53,125,30,53,95,24,119,2,65,52,33,19
TAMIL NADU,"HURT (SECTION 323, 324 TO 333, 335 TO 338 IPC)",16719,36059,889,16774,35115,64473,99588,34,72828,26726,10736,15990
TRIPURA,"HURT (SECTION 323, 324 TO 333, 335 TO 338 IPC)",686,2055,264,348,2129,1492,3621,0,2257,1364,178,1186
UTTAR PRADESH,"HURT (SECTION 323, 324 TO 333, 335 TO 338 IPC)",1267,34875,1883,1168,33091,92779,125870,5594,105583,14693,7282,7411
UTTARAKHAND,"HURT (SECTION 323, 324 TO 333, 335 TO 338 IPC)",84,1401,2,90,1393,3594,4987,1013,3330,644,397,247
WEST BENGAL,"HURT (SECTION 323, 324 TO 333, 335 TO 338 IPC)",3140,20802,1057,3174,19711,47459,67170,1238,60178,5754,830,4924
TOTAL (STATES),"HURT (SECTION 323, 324 TO 333, 335 TO 338 IPC)",94992,567637,10333,99418,552878,2006096,2558974,92622,2121655,344697,89821,254876
A & N ISLANDS,"HURT (SECTION 323, 324 TO 333, 335 TO 338 IPC)",79,85,0,67,97,1093,1190,0,1133,57,18,39
CHANDIGARH,"HURT (SECTION 323, 324 TO 333, 335 TO 338 IPC)",47,66,1,16,96,340,436,0,336,100,27,73
D & N HAVELI,"HURT (SECTION 323, 324 TO 333, 335 TO 338 IPC)",13,57,0,14,56,360,416,0,372,44,0,44
DAMAN & DIU,"HURT (SECTION 323, 324 TO 333, 335 TO 338 IPC)",10,28,0,6,32,37,69,4,58,7,0,7
DELHI,"HURT (SECTION 323, 324 TO 333, 335 TO 338 IPC)",1972,3092,125,1719,3220,28215,31435,0,28849,2586,1061,1525
LAKSHADWEEP,"HURT (SECTION 323, 324 TO 333, 335 TO 338 IPC)",76,5,0,78,3,1,4,0,3,1,0,1
PUDUCHERRY,"HURT (SECTION 323, 324 TO 333, 335 TO 338 IPC)",41,1629,0,204,1466,2415,3881,37,2945,899,355,544
TOTAL (UTs),"HURT (SECTION 323, 324 TO 333, 335 TO 338 IPC)",2238,4962,126,2104,4970,32461,37431,41,33696,3694,1461,2233
TOTAL (ALL-INDIA),"HURT (SECTION 323, 324 TO 333, 335 TO 338 IPC)",97230,572599,10459,101522,557848,2038557,2596405,92663,2155351,348391,91282,257109
ANDHRA PRADESH,DOWRY DEATHS (SECTION 304B IPC),667,1267,0,543,1391,2664,4055,5,2875,1175,146,1029
ARUNACHAL PRADESH,DOWRY DEATHS (SECTION 304B IPC),0,2,0,2,0,0,0,0,0,0,0,0
ASSAM,DOWRY DEATHS (SECTION 304B IPC),339,215,61,340,153,635,788,0,718,70,18,52
BIHAR,DOWRY DEATHS (SECTION 304B IPC),3251,3994,21,3483,3741,13343,17084,0,15130,1954,314,1640
CHHATTISGARH,DOWRY DEATHS (SECTION 304B IPC),3,211,0,1,213,946,1159,0,889,270,106,164
GOA,DOWRY DEATHS (SECTION 304B IPC),2,0,0,0,2,26,28,0,28,0,0,0
GUJARAT,DOWRY DEATHS (SECTION 304B IPC),4,38,0,4,38,1658,1696,0,1628,68,0,68
HARYANA,DOWRY DEATHS (SECTION 304B IPC),53,481,0,66,468,1156,1624,0,1171,453,125,328
HIMACHAL PRADESH,DOWRY DEATHS (SECTION 304B IPC),0,4,0,0,4,80,84,0,74,10,0,10
JAMMU & KASHMIR,DOWRY DEATHS (SECTION 304B IPC),5,23,0,5,23,144,167,0,153,14,2,12
JHARKHAND,DOWRY DEATHS (SECTION 304B IPC),475,444,0,429,490,973,1463,4,1003,456,173,283
KARNATAKA,DOWRY DEATHS (SECTION 304B IPC),119,539,6,113,539,1913,2452,5,1942,505,62,443
KERALA,DOWRY DEATHS (SECTION 304B IPC),17,38,1,24,30,327,357,3,331,23,2,21
MADHYA PRADESH,DOWRY DEATHS (SECTION 304B IPC),42,2142,0,38,2146,6522,8668,51,7007,1610,536,1074
MAHARASHTRA,DOWRY DEATHS (SECTION 304B IPC),505,1141,2,515,1129,10730,11859,16,11242,601,85,516
MANIPUR,DOWRY DEATHS (SECTION 304B IPC),5,0,0,5,0,0,0,0,0,0,0,0
MEGHALAYA,DOWRY DEATHS (SECTION 304B IPC),3,4,0,7,0,13,13,0,13,0,0,0
MIZORAM,DOWRY DEATHS (SECTION 304B IPC),0,0,0,0,0,0,0,0,0,0,0,0
NAGALAND,DOWRY DEATHS (SECTION 304B IPC),0,0,0,0,0,0,0,0,0,0,0,0
ODISHA,DOWRY DEATHS (SECTION 304B IPC),181,903,0,209,875,2811,3686,0,2943,743,45,698
PUNJAB,DOWRY DEATHS (SECTION 304B IPC),401,274,15,437,223,813,1036,0,820,216,109,107
RAJASTHAN,DOWRY DEATHS (SECTION 304B IPC),20,631,0,22,629,3002,3631,32,3106,493,196,297
SIKKIM,DOWRY DEATHS (SECTION 304B IPC),2,9,2,5,4,0,4,0,4,0,0,0
TAMIL NADU,DOWRY DEATHS (SECTION 304B IPC),351,278,6,280,343,987,1330,0,1040,290,59,231
TRIPURA,DOWRY DEATHS (SECTION 304B IPC),20,87,19,39,49,82,131,0,104,27,8,19
UTTAR PRADESH,DOWRY DEATHS (SECTION 304B IPC),1462,9884,3307,1803,6236,21917,28153,107,24143,3903,1936,1967
UTTARAKHAND,DOWRY DEATHS (SECTION 304B IPC),55,147,0,13,189,542,731,0,468,263,144,119
WEST BENGAL,DOWRY DEATHS (SECTION 304B IPC),627,1345,49,578,1345,3592,4937,3,3854,1080,79,1001
TOTAL (STATES),DOWRY DEATHS (SECTION 304B IPC),8609,24101,3489,8961,20260,74876,95136,226,80686,14224,4145,10079
A & N ISLANDS,DOWRY DEATHS (SECTION 304B IPC),0,3,0,0,3,5,8,0,8,0,0,0
CHANDIGARH,DOWRY DEATHS (SECTION 304B IPC),3,14,0,2,15,6,21,0,8,13,3,10
D & N HAVELI,DOWRY DEATHS (SECTION 304B IPC),0,0,0,0,0,4,4,0,4,0,0,0
DAMAN & DIU,DOWRY DEATHS (SECTION 304B IPC),0,0,0,0,0,0,0,0,0,0,0,0
DELHI,DOWRY DEATHS (SECTION 304B IPC),202,300,9,176,317,2121,2438,0,2134,304,148,156
LAKSHADWEEP,DOWRY DEATHS (SECTION 304B IPC),0,0,0,0,0,0,0,0,0,0,0,0
PUDUCHERRY,DOWRY DEATHS (SECTION 304B IPC),8,0,0,3,5,17,22,0,21,1,0,1
TOTAL (UTs),DOWRY DEATHS (SECTION 304B IPC),213,317,9,181,340,2153,2493,0,2175,318,151,167
TOTAL (ALL-INDIA),DOWRY DEATHS (SECTION 304B IPC),8822,24418,3498,9142,20600,77029,97629,226,82861,14542,4296,10246
ANDHRA PRADESH,ASSAULT ON WOMEN WITH INTENT TO OUTRAGE HER MODESTY(SECTION 354 IPC),1364,4834,0,1471,4727,7351,12078,522,8192,3364,419,2945
ARUNACHAL PRADESH,ASSAULT ON WOMEN WITH INTENT TO OUTRAGE HER MODESTY(SECTION 354 IPC),41,77,13,53,52,459,511,2,478,31,12,19
ASSAM,ASSAULT ON WOMEN WITH INTENT TO OUTRAGE HER MODESTY(SECTION 354 IPC),1337,2250,880,1497,1210,2492,3702,25,2753,924,97,827
BIHAR,ASSAULT ON WOMEN WITH INTENT TO OUTRAGE HER MODESTY(SECTION 354 IPC),585,278,35,189,639,3556,4195,97,3489,609,59,550
CHHATTISGARH,ASSAULT ON WOMEN WITH INTENT TO OUTRAGE HER MODESTY(SECTION 354 IPC),61,1891,0,73,1879,8425,10304,189,8609,1506,491,1015
GOA,ASSAULT ON WOMEN WITH INTENT TO OUTRAGE HER MODESTY(SECTION 354 IPC),14,42,1,31,24,114,138,0,120,18,1,17
GUJARAT,ASSAULT ON WOMEN WITH INTENT TO OUTRAGE HER MODESTY(SECTION 354 IPC),69,1118,0,78,1109,10312,11421,53,10673,695,8,687
HARYANA,ASSAULT ON WOMEN WITH INTENT TO OUTRAGE HER MODESTY(SECTION 354 IPC),65,698,0,30,733,2402,3135,0,2402,733,147,586
HIMACHAL PRADESH,ASSAULT ON WOMEN WITH INTENT TO OUTRAGE HER MODESTY(SECTION 354 IPC),50,317,0,35,332,1969,2301,55,1995,251,33,218
JAMMU & KASHMIR,ASSAULT ON WOMEN WITH INTENT TO OUTRAGE HER MODESTY(SECTION 354 IPC),10,2814,0,10,2814,12757,15571,688,12386,2497,155,2342
JHARKHAND,ASSAULT ON WOMEN WITH INTENT TO OUTRAGE HER MODESTY(SECTION 354 IPC),109,355,0,109,355,727,1082,7,721,354,149,205
KARNATAKA,ASSAULT ON WOMEN WITH INTENT TO OUTRAGE HER MODESTY(SECTION 354 IPC),550,3982,63,608,3861,7583,11444,277,8350,2817,174,2643
KERALA,ASSAULT ON WOMEN WITH INTENT TO OUTRAGE HER MODESTY(SECTION 354 IPC),474,4167,1,509,4131,14677,18808,140,16466,2202,285,1917
MADHYA PRADESH,ASSAULT ON WOMEN WITH INTENT TO OUTRAGE HER MODESTY(SECTION 354 IPC),11,8085,0,34,8062,27063,35125,2272,28080,4773,1655,3118
MAHARASHTRA,ASSAULT ON WOMEN WITH INTENT TO OUTRAGE HER MODESTY(SECTION 354 IPC),1323,4885,10,1475,4723,34065,38788,758,35042,2988,256,2732
MANIPUR,ASSAULT ON WOMEN WITH INTENT TO OUTRAGE HER MODESTY(SECTION 354 IPC),52,34,29,50,7,10,17,0,17,0,0,0
MEGHALAYA,ASSAULT ON WOMEN WITH INTENT TO OUTRAGE HER MODESTY(SECTION 354 IPC),22,45,1,32,34,219,253,0,244,9,2,7
MIZORAM,ASSAULT ON WOMEN WITH INTENT TO OUTRAGE HER MODESTY(SECTION 354 IPC),5,82,0,9,78,71,149,0,80,69,47,22
NAGALAND,ASSAULT ON WOMEN WITH INTENT TO OUTRAGE HER MODESTY(SECTION 354 IPC),4,16,1,4,15,10,25,0,13,12,12,0
ODISHA,ASSAULT ON WOMEN WITH INTENT TO OUTRAGE HER MODESTY(SECTION 354 IPC),288,6060,31,438,5879,24969,30848,0,28413,2435,246,2189
PUNJAB,ASSAULT ON WOMEN WITH INTENT TO OUTRAGE HER MODESTY(SECTION 354 IPC),333,413,19,443,284,1191,1475,0,1222,253,79,174
RAJASTHAN,ASSAULT ON WOMEN WITH INTENT TO OUTRAGE HER MODESTY(SECTION 354 IPC),4,2658,0,6,2656,14322,16978,651,14173,2154,1145,1009
SIKKIM,ASSAULT ON WOMEN WITH INTENT TO OUTRAGE HER MODESTY(SECTION 354 IPC),12,17,12,8,9,28,37,1,29,7,1,6
TAMIL NADU,ASSAULT ON WOMEN WITH INTENT TO OUTRAGE HER MODESTY(SECTION 354 IPC),1018,2091,66,1069,1974,4704,6678,0,5483,1195,387,808
TRIPURA,ASSAULT ON WOMEN WITH INTENT TO OUTRAGE HER MODESTY(SECTION 354 IPC),107,375,29,86,367,225,592,0,247,345,44,301
UTTAR PRADESH,ASSAULT ON WOMEN WITH INTENT TO OUTRAGE HER MODESTY(SECTION 354 IPC),205,5143,590,347,4411,10053,14464,127,11854,2483,1506,977
UTTARAKHAND,ASSAULT ON WOMEN WITH INTENT TO OUTRAGE HER MODESTY(SECTION 354 IPC),6,199,0,8,197,624,821,22,590,209,168,41
WEST BENGAL,ASSAULT ON WOMEN WITH INTENT TO OUTRAGE HER MODESTY(SECTION 354 IPC),571,2879,133,420,2897,12653,15550,87,14268,1195,138,1057
TOTAL (STATES),ASSAULT ON WOMEN WITH INTENT TO OUTRAGE HER MODESTY(SECTION 354 IPC),8690,55805,1914,9122,53459,203031,256490,5973,216389,34128,7716,26412
A & N ISLANDS,ASSAULT ON WOMEN WITH INTENT TO OUTRAGE HER MODESTY(SECTION 354 IPC),16,20,0,22,14,264,278,0,265,13,1,12
CHANDIGARH,ASSAULT ON WOMEN WITH INTENT TO OUTRAGE HER MODESTY(SECTION 354 IPC),7,54,0,33,28,104,132,0,107,25,1,24
D & N HAVELI,ASSAULT ON WOMEN WITH INTENT TO OUTRAGE HER MODESTY(SECTION 354 IPC),1,2,0,1,2,33,35,0,30,5,1,4
DAMAN & DIU,ASSAULT ON WOMEN WITH INTENT TO OUTRAGE HER MODESTY(SECTION 354 IPC),5,0,0,5,0,1,1,0,0,1,0,1
DELHI,ASSAULT ON WOMEN WITH INTENT TO OUTRAGE HER MODESTY(SECTION 354 IPC),676,939,31,698,886,4990,5876,0,4867,1009,452,557
LAKSHADWEEP,ASSAULT ON WOMEN WITH INTENT TO OUTRAGE HER MODESTY(SECTION 354 IPC),0,0,0,0,0,0,0,0,0,0,0,0
PUDUCHERRY,ASSAULT ON WOMEN WITH INTENT TO OUTRAGE HER MODESTY(SECTION 354 IPC),21,7,0,15,13,315,328,0,262,66,12,54
TOTAL (UTs),ASSAULT ON WOMEN WITH INTENT TO OUTRAGE HER MODESTY(SECTION 354 IPC),726,1022,31,774,943,5707,6650,0,5531,1119,467,652
TOTAL (ALL-INDIA),ASSAULT ON WOMEN WITH INTENT TO OUTRAGE HER MODESTY(SECTION 354 IPC),9416,56827,1945,9896,54402,208738,263140,5973,221920,35247,8183,27064
ANDHRA PRADESH,INSULT TO MODESTY OF WOMEN(SECTION 509 IPC),591,4348,0,862,4077,4666,8743,826,5427,2490,690,1800
ARUNACHAL PRADESH,INSULT TO MODESTY OF WOMEN(SECTION 509 IPC),0,0,0,0,0,17,17,0,17,0,0,0
ASSAM,INSULT TO MODESTY OF WOMEN(SECTION 509 IPC),28,12,5,27,8,9,17,0,16,1,0,1
BIHAR,INSULT TO MODESTY OF WOMEN(SECTION 509 IPC),3,39,2,0,40,69,109,7,77,25,0,25
CHHATTISGARH,INSULT TO MODESTY OF WOMEN(SECTION 509 IPC),2,193,0,0,195,861,1056,0,899,157,38,119
GOA,INSULT TO MODESTY OF WOMEN(SECTION 509 IPC),13,17,1,21,8,38,46,1,41,4,1,3
GUJARAT,INSULT TO MODESTY OF WOMEN(SECTION 509 IPC),6,117,0,3,120,1429,1549,3,1445,101,16,85
HARYANA,INSULT TO MODESTY OF WOMEN(SECTION 509 IPC),43,558,0,24,577,1472,2049,0,1503,546,313,233
HIMACHAL PRADESH,INSULT TO MODESTY OF WOMEN(SECTION 509 IPC),3,91,0,15,79,279,358,9,333,16,2,14
JAMMU & KASHMIR,INSULT TO MODESTY OF WOMEN(SECTION 509 IPC),3,447,0,3,447,2025,2472,7,2026,439,149,290
JHARKHAND,INSULT TO MODESTY OF WOMEN(SECTION 509 IPC),8,51,0,30,29,67,96,0,80,16,6,10
KARNATAKA,INSULT TO MODESTY OF WOMEN(SECTION 509 IPC),1,147,0,11,137,100,237,0,124,113,2,111
KERALA,INSULT TO MODESTY OF WOMEN(SECTION 509 IPC),55,538,0,77,516,1494,2010,15,1707,288,101,187
MADHYA PRADESH,INSULT TO MODESTY OF WOMEN(SECTION 509 IPC),4,1056,0,2,1058,2524,3582,197,2829,556,190,366
MAHARASHTRA,INSULT TO MODESTY OF WOMEN(SECTION 509 IPC),306,1548,5,416,1433,10960,12393,295,11404,694,34,660
MANIPUR,INSULT TO MODESTY OF WOMEN(SECTION 509 IPC),1,0,0,1,0,1,1,0,1,0,0,0
MEGHALAYA,INSULT TO MODESTY OF WOMEN(SECTION 509 IPC),0,0,0,0,0,1,1,0,1,0,0,0
MIZORAM,INSULT TO MODESTY OF WOMEN(SECTION 509 IPC),0,1,0,0,1,0,1,0,0,1,1,0
NAGALAND,INSULT TO MODESTY OF WOMEN(SECTION 509 IPC),0,0,0,0,0,2,2,0,2,0,0,0
ODISHA,INSULT TO MODESTY OF WOMEN(SECTION 509 IPC),38,376,0,43,371,1788,2159,0,1899,260,23,237
PUNJAB,INSULT TO MODESTY OF WOMEN(SECTION 509 IPC),49,45,4,66,24,82,106,0,86,20,5,15
RAJASTHAN,INSULT TO MODESTY OF WOMEN(SECTION 509 IPC),0,20,0,0,20,88,108,0,97,11,4,7
SIKKIM,INSULT TO MODESTY OF WOMEN(SECTION 509 IPC),0,0,0,0,0,0,0,0,0,0,0,0
TAMIL NADU,INSULT TO MODESTY OF WOMEN(SECTION 509 IPC),99,470,20,217,332,1448,1780,0,1363,417,154,263
TRIPURA,INSULT TO MODESTY OF WOMEN(SECTION 509 IPC),0,15,0,0,15,13,28,0,18,10,1,9
UTTAR PRADESH,INSULT TO MODESTY OF WOMEN(SECTION 509 IPC),2,14,2,0,14,2490,2504,18,320,2166,1167,999
UTTARAKHAND,INSULT TO MODESTY OF WOMEN(SECTION 509 IPC),2,103,0,7,98,766,864,4,784,76,66,10
WEST BENGAL,INSULT TO MODESTY OF WOMEN(SECTION 509 IPC),102,617,69,244,406,167,573,21,317,235,99,136
TOTAL (STATES),INSULT TO MODESTY OF WOMEN(SECTION 509 IPC),1359,10823,108,2069,10005,32856,42861,1403,32816,8642,3062,5580
A & N ISLANDS,INSULT TO MODESTY OF WOMEN(SECTION 509 IPC),5,6,0,7,4,46,50,0,49,1,0,1
CHANDIGARH,INSULT TO MODESTY OF WOMEN(SECTION 509 IPC),1,32,0,11,22,39,61,0,51,10,0,10
D & N HAVELI,INSULT TO MODESTY OF WOMEN(SECTION 509 IPC),0,0,0,0,0,4,4,0,2,2,0,2
DAMAN & DIU,INSULT TO MODESTY OF WOMEN(SECTION 509 IPC),0,0,0,0,0,2,2,0,0,2,0,2
DELHI,INSULT TO MODESTY OF WOMEN(SECTION 509 IPC),114,231,7,145,193,536,729,0,549,180,73,107
LAKSHADWEEP,INSULT TO MODESTY OF WOMEN(SECTION 509 IPC),0,0,0,0,0,0,0,0,0,0,0,0
PUDUCHERRY,INSULT TO MODESTY OF WOMEN(SECTION 509 IPC),8,17,0,2,23,127,150,0,120,30,1,29
TOTAL (UTs),INSULT TO MODESTY OF WOMEN(SECTION 509 IPC),128,286,7,165,242,754,996,0,771,225,74,151
TOTAL (ALL-INDIA),INSULT TO MODESTY OF WOMEN(SECTION 509 IPC),1487,11109,115,2234,10247,33610,43857,1403,33587,8867,3136,5731
ANDHRA PRADESH,CRUELTY BY HUSBAND OR HIS RELATIVES (SECTION 498A IPC),5465,21251,0,5377,21339,38048,59387,5158,39554,14675,1586,13089
ARUNACHAL PRADESH,CRUELTY BY HUSBAND OR HIS RELATIVES (SECTION 498A IPC),9,26,4,11,20,77,97,2,91,4,2,2
ASSAM,CRUELTY BY HUSBAND OR HIS RELATIVES (SECTION 498A IPC),3619,5435,1703,3588,3763,7384,11147,272,8152,2723,287,2436
BIHAR,CRUELTY BY HUSBAND OR HIS RELATIVES (SECTION 498A IPC),5436,6963,111,5318,6970,13712,20682,314,17857,2511,368,2143
CHHATTISGARH,CRUELTY BY HUSBAND OR HIS RELATIVES (SECTION 498A IPC),105,2581,0,111,2575,10174,12749,1020,9745,1984,604,1380
GOA,CRUELTY BY HUSBAND OR HIS RELATIVES (SECTION 498A IPC),29,54,4,59,20,148,168,0,147,21,1,20
GUJARAT,CRUELTY BY HUSBAND OR HIS RELATIVES (SECTION 498A IPC),1063,19982,0,1407,19638,122491,142129,493,131733,9903,299,9604
HARYANA,CRUELTY BY HUSBAND OR HIS RELATIVES (SECTION 498A IPC),669,3606,0,636,3639,15012,18651,127,14197,4327,345,3982
HIMACHAL PRADESH,CRUELTY BY HUSBAND OR HIS RELATIVES (SECTION 498A IPC),112,505,7,91,519,3149,3668,192,3050,426,15,411
JAMMU & KASHMIR,CRUELTY BY HUSBAND OR HIS RELATIVES (SECTION 498A IPC),11,634,0,11,634,1585,2219,205,1813,201,2,199
JHARKHAND,CRUELTY BY HUSBAND OR HIS RELATIVES (SECTION 498A IPC),704,2207,5,1095,1811,2267,4078,77,2836,1165,251,914
KARNATAKA,CRUELTY BY HUSBAND OR HIS RELATIVES (SECTION 498A IPC),1027,6317,164,1261,5919,13399,19318,263,14745,4310,174,4136
KERALA,CRUELTY BY HUSBAND OR HIS RELATIVES (SECTION 498A IPC),993,6923,1,1203,6712,26731,33443,140,28944,4359,254,4105
MADHYA PRADESH,CRUELTY BY HUSBAND OR HIS RELATIVES (SECTION 498A IPC),75,11104,0,69,11110,35967,47077,2515,38448,6114,1937,4177
MAHARASHTRA,CRUELTY BY HUSBAND OR HIS RELATIVES (SECTION 498A IPC),6901,27379,40,7563,26677,187451,214128,2062,190956,21110,372,20738
MANIPUR,CRUELTY BY HUSBAND OR HIS RELATIVES (SECTION 498A IPC),38,21,16,36,7,3,10,0,10,0,0,0
MEGHALAYA,CRUELTY BY HUSBAND OR HIS RELATIVES (SECTION 498A IPC),21,14,1,22,12,46,58,0,58,0,0,0
MIZORAM,CRUELTY BY HUSBAND OR HIS RELATIVES (SECTION 498A IPC),0,7,0,0,7,1,8,0,0,8,7,1
NAGALAND,CRUELTY BY HUSBAND OR HIS RELATIVES (SECTION 498A IPC),0,0,0,0,0,1,1,0,1,0,0,0
ODISHA,CRUELTY BY HUSBAND OR HIS RELATIVES (SECTION 498A IPC),649,4699,9,435,4904,16362,21266,0,18636,2630,256,2374
PUNJAB,CRUELTY BY HUSBAND OR HIS RELATIVES (SECTION 498A IPC),1546,2288,161,2183,1490,8844,10334,0,9029,1305,408,897
RAJASTHAN,CRUELTY BY HUSBAND OR HIS RELATIVES (SECTION 498A IPC),151,9949,0,131,9969,43468,53437,2060,44849,6528,2341,4187
SIKKIM,CRUELTY BY HUSBAND OR HIS RELATIVES (SECTION 498A IPC),3,6,1,4,4,16,20,0,10,10,6,4
TAMIL NADU,CRUELTY BY HUSBAND OR HIS RELATIVES (SECTION 498A IPC),1371,4019,63,2235,3092,7115,10207,2,7841,2364,495,1869
TRIPURA,CRUELTY BY HUSBAND OR HIS RELATIVES (SECTION 498A IPC),583,1147,152,282,1296,1988,3284,0,1686,1598,270,1328
UTTAR PRADESH,CRUELTY BY HUSBAND OR HIS RELATIVES (SECTION 498A IPC),4169,36115,9519,11076,19689,54863,74552,1771,62614,10167,5105,5062
UTTARAKHAND,CRUELTY BY HUSBAND OR HIS RELATIVES (SECTION 498A IPC),29,484,7,120,386,2609,2995,82,2577,336,175,161
WEST BENGAL,CRUELTY BY HUSBAND OR HIS RELATIVES (SECTION 498A IPC),5879,22911,1445,4262,23083,95405,118488,412,109132,8944,377,8567
TOTAL (STATES),CRUELTY BY HUSBAND OR HIS RELATIVES (SECTION 498A IPC),40657,196627,13413,48586,175285,708316,883601,17167,758711,107723,15937,91786
A & N ISLANDS,CRUELTY BY HUSBAND OR HIS RELATIVES (SECTION 498A IPC),3,4,0,4,3,140,143,0,140,3,0,3
CHANDIGARH,CRUELTY BY HUSBAND OR HIS RELATIVES (SECTION 498A IPC),34,86,1,26,93,477,570,0,474,96,17,79
D & N HAVELI,CRUELTY BY HUSBAND OR HIS RELATIVES (SECTION 498A IPC),4,0,0,0,4,44,48,0,44,4,0,4
DAMAN & DIU,CRUELTY BY HUSBAND OR HIS RELATIVES (SECTION 498A IPC),0,11,0,3,8,42,50,0,31,19,0,19
DELHI,CRUELTY BY HUSBAND OR HIS RELATIVES (SECTION 498A IPC),79,1026,41,438,626,14766,15392,0,13989,1403,448,955
LAKSHADWEEP,CRUELTY BY HUSBAND OR HIS RELATIVES (SECTION 498A IPC),0,1,0,1,0,2,2,2,0,0,0,0
PUDUCHERRY,CRUELTY BY HUSBAND OR HIS RELATIVES (SECTION 498A IPC),10,7,0,6,11,66,77,0,56,21,0,21
TOTAL (UTs),CRUELTY BY HUSBAND OR HIS RELATIVES (SECTION 498A IPC),130,1135,42,478,745,15537,16282,2,14734,1546,465,1081
TOTAL (ALL-INDIA),CRUELTY BY HUSBAND OR HIS RELATIVES (SECTION 498A IPC),40787,197762,13455,49064,176030,723853,899883,17169,773445,109269,16402,92867
ANDHRA PRADESH,IMPORTATION OF GIRLS FROM FOREIGN COUNTRY (SECTION 366B IPC),0,0,0,0,0,2,2,0,2,0,0,0
ARUNACHAL PRADESH,IMPORTATION OF GIRLS FROM FOREIGN COUNTRY (SECTION 366B IPC),0,0,0,0,0,0,0,0,0,0,0,0
ASSAM,IMPORTATION OF GIRLS FROM FOREIGN COUNTRY (SECTION 366B IPC),0,2,0,2,0,4,4,0,2,2,0,2
BIHAR,IMPORTATION OF GIRLS FROM FOREIGN COUNTRY (SECTION 366B IPC),13,6,0,15,4,415,419,0,354,65,7,58
CHHATTISGARH,IMPORTATION OF GIRLS FROM FOREIGN COUNTRY (SECTION 366B IPC),1,0,0,0,1,12,13,1,11,1,1,0
GOA,IMPORTATION OF GIRLS FROM FOREIGN COUNTRY (SECTION 366B IPC),0,0,0,0,0,0,0,0,0,0,0,0
GUJARAT,IMPORTATION OF GIRLS FROM FOREIGN COUNTRY (SECTION 366B IPC),0,0,0,0,0,0,0,0,0,0,0,0
HARYANA,IMPORTATION OF GIRLS FROM FOREIGN COUNTRY (SECTION 366B IPC),0,0,0,0,0,0,0,0,0,0,0,0
HIMACHAL PRADESH,IMPORTATION OF GIRLS FROM FOREIGN COUNTRY (SECTION 366B IPC),0,0,0,0,0,0,0,0,0,0,0,0
JAMMU & KASHMIR,IMPORTATION OF GIRLS FROM FOREIGN COUNTRY (SECTION 366B IPC),0,0,0,0,0,0,0,0,0,0,0,0
JHARKHAND,IMPORTATION OF GIRLS FROM FOREIGN COUNTRY (SECTION 366B IPC),10,3,0,10,3,20,23,1,19,3,1,2
KARNATAKA,IMPORTATION OF GIRLS FROM FOREIGN COUNTRY (SECTION 366B IPC),0,0,0,0,0,2,2,0,2,0,0,0
KERALA,IMPORTATION OF GIRLS FROM FOREIGN COUNTRY (SECTION 366B IPC),0,0,0,0,0,0,0,0,0,0,0,0
MADHYA PRADESH,IMPORTATION OF GIRLS FROM FOREIGN COUNTRY (SECTION 366B IPC),5,10,0,0,15,192,207,13,180,14,3,11
MAHARASHTRA,IMPORTATION OF GIRLS FROM FOREIGN COUNTRY (SECTION 366B IPC),0,0,0,0,0,0,0,0,0,0,0,0
MANIPUR,IMPORTATION OF GIRLS FROM FOREIGN COUNTRY (SECTION 366B IPC),0,0,0,0,0,0,0,0,0,0,0,0
MEGHALAYA,IMPORTATION OF GIRLS FROM FOREIGN COUNTRY (SECTION 366B IPC),2,0,0,0,2,0,2,0,2,0,0,0
MIZORAM,IMPORTATION OF GIRLS FROM FOREIGN COUNTRY (SECTION 366B IPC),0,0,0,0,0,0,0,0,0,0,0,0
NAGALAND,IMPORTATION OF GIRLS FROM FOREIGN COUNTRY (SECTION 366B IPC),0,0,0,0,0,0,0,0,0,0,0,0
ODISHA,IMPORTATION OF GIRLS FROM FOREIGN COUNTRY (SECTION 366B IPC),0,0,0,0,0,8,8,0,8,0,0,0
PUNJAB,IMPORTATION OF GIRLS FROM FOREIGN COUNTRY (SECTION 366B IPC),0,0,0,0,0,0,0,0,0,0,0,0
RAJASTHAN,IMPORTATION OF GIRLS FROM FOREIGN COUNTRY (SECTION 366B IPC),0,0,0,0,0,1,1,0,1,0,0,0
SIKKIM,IMPORTATION OF GIRLS FROM FOREIGN COUNTRY (SECTION 366B IPC),0,0,0,0,0,0,0,0,0,0,0,0
TAMIL NADU,IMPORTATION OF GIRLS FROM FOREIGN COUNTRY (SECTION 366B IPC),0,0,0,0,0,0,0,0,0,0,0,0
TRIPURA,IMPORTATION OF GIRLS FROM FOREIGN COUNTRY (SECTION 366B IPC),0,0,0,0,0,0,0,0,0,0,0,0
UTTAR PRADESH,IMPORTATION OF GIRLS FROM FOREIGN COUNTRY (SECTION 366B IPC),0,0,0,0,0,0,0,0,0,0,0,0
UTTARAKHAND,IMPORTATION OF GIRLS FROM FOREIGN COUNTRY (SECTION 366B IPC),0,0,0,0,0,0,0,0,0,0,0,0
WEST BENGAL,IMPORTATION OF GIRLS FROM FOREIGN COUNTRY (SECTION 366B IPC),5,25,5,5,20,10,30,0,17,13,2,11
TOTAL (STATES),IMPORTATION OF GIRLS FROM FOREIGN COUNTRY (SECTION 366B IPC),36,46,5,32,45,666,711,15,598,98,14,84
A & N ISLANDS,IMPORTATION OF GIRLS FROM FOREIGN COUNTRY (SECTION 366B IPC),0,0,0,0,0,0,0,0,0,0,0,0
CHANDIGARH,IMPORTATION OF GIRLS FROM FOREIGN COUNTRY (SECTION 366B IPC),0,0,0,0,0,0,0,0,0,0,0,0
D & N HAVELI,IMPORTATION OF GIRLS FROM FOREIGN COUNTRY (SECTION 366B IPC),0,0,0,0,0,0,0,0,0,0,0,0
DAMAN & DIU,IMPORTATION OF GIRLS FROM FOREIGN COUNTRY (SECTION 366B IPC),0,0,0,0,0,0,0,0,0,0,0,0
DELHI,IMPORTATION OF GIRLS FROM FOREIGN COUNTRY (SECTION 366B IPC),0,0,0,0,0,0,0,0,0,0,0,0
LAKSHADWEEP,IMPORTATION OF GIRLS FROM FOREIGN COUNTRY (SECTION 366B IPC),0,0,0,0,0,0,0,0,0,0,0,0
PUDUCHERRY,IMPORTATION OF GIRLS FROM FOREIGN COUNTRY (SECTION 366B IPC),0,0,0,0,0,0,0,0,0,0,0,0
TOTAL (UTs),IMPORTATION OF GIRLS FROM FOREIGN COUNTRY (SECTION 366B IPC),0,0,0,0,0,0,0,0,0,0,0,0
TOTAL (ALL-INDIA),IMPORTATION OF GIRLS FROM FOREIGN COUNTRY (SECTION 366B IPC),36,46,5,32,45,666,711,15,598,98,14,84
ANDHRA PRADESH,CAUSING DEATH BY NEGLIGENCE (SECTION 304-A IPC),3197,11779,17,3077,11882,26999,38881,534,28516,9831,1015,8816
ARUNACHAL PRADESH,CAUSING DEATH BY NEGLIGENCE (SECTION 304-A IPC),21,86,27,38,42,241,283,0,266,17,11,6
ASSAM,CAUSING DEATH BY NEGLIGENCE (SECTION 304-A IPC),2913,2451,1004,2824,1536,5572,7108,0,5831,1277,154,1123
BIHAR,CAUSING DEATH BY NEGLIGENCE (SECTION 304-A IPC),2929,4369,44,2276,4978,15707,20685,240,18952,1493,240,1253
CHHATTISGARH,CAUSING DEATH BY NEGLIGENCE (SECTION 304-A IPC),105,2022,0,209,1918,7856,9774,577,6888,2309,756,1553
GOA,CAUSING DEATH BY NEGLIGENCE (SECTION 304-A IPC),121,186,4,126,177,838,1015,0,856,159,26,133
GUJARAT,CAUSING DEATH BY NEGLIGENCE (SECTION 304-A IPC),527,3945,0,525,3947,29956,33903,189,31252,2462,273,2189
HARYANA,CAUSING DEATH BY NEGLIGENCE (SECTION 304-A IPC),267,989,0,172,1084,4377,5461,0,4168,1293,235,1058
HIMACHAL PRADESH,CAUSING DEATH BY NEGLIGENCE (SECTION 304-A IPC),99,306,2,56,347,1929,2276,8,1966,302,38,264
JAMMU & KASHMIR,CAUSING DEATH BY NEGLIGENCE (SECTION 304-A IPC),4,357,0,5,356,1293,1649,1,1300,348,59,289
JHARKHAND,CAUSING DEATH BY NEGLIGENCE (SECTION 304-A IPC),543,944,0,535,952,1308,2260,18,1279,963,292,671
KARNATAKA,CAUSING DEATH BY NEGLIGENCE (SECTION 304-A IPC),131,786,8,157,752,1539,2291,3,1893,395,18,377
KERALA,CAUSING DEATH BY NEGLIGENCE (SECTION 304-A IPC),33,53,0,21,65,256,321,0,301,20,2,18
MADHYA PRADESH,CAUSING DEATH BY NEGLIGENCE (SECTION 304-A IPC),72,6729,0,74,6727,19437,26164,371,21139,4654,1483,3171
MAHARASHTRA,CAUSING DEATH BY NEGLIGENCE (SECTION 304-A IPC),3007,9983,18,3283,9689,90076,99765,1809,90096,7860,380,7480
MANIPUR,CAUSING DEATH BY NEGLIGENCE (SECTION 304-A IPC),9,1,1,9,0,1,1,0,1,0,0,0
MEGHALAYA,CAUSING DEATH BY NEGLIGENCE (SECTION 304-A IPC),24,70,6,18,70,128,198,3,175,20,15,5
MIZORAM,CAUSING DEATH BY NEGLIGENCE (SECTION 304-A IPC),5,33,0,10,28,13,41,0,19,22,20,2
NAGALAND,CAUSING DEATH BY NEGLIGENCE (SECTION 304-A IPC),3,17,3,8,9,9,18,0,7,11,9,2
ODISHA,CAUSING DEATH BY NEGLIGENCE (SECTION 304-A IPC),280,3294,0,260,3314,19166,22480,0,19748,2732,512,2220
PUNJAB,CAUSING DEATH BY NEGLIGENCE (SECTION 304-A IPC),1829,2563,62,2084,2246,9116,11362,0,9209,2153,714,1439
RAJASTHAN,CAUSING DEATH BY NEGLIGENCE (SECTION 304-A IPC),5,6852,0,9,6848,35328,42176,374,36565,5237,2139,3098
SIKKIM,CAUSING DEATH BY NEGLIGENCE (SECTION 304-A IPC),5,21,5,10,11,95,106,23,58,25,14,11
TAMIL NADU,CAUSING DEATH BY NEGLIGENCE (SECTION 304-A IPC),7807,12572,408,7049,12922,28542,41464,19,34617,6828,1564,5264
TRIPURA,CAUSING DEATH BY NEGLIGENCE (SECTION 304-A IPC),81,14,0,23,72,133,205,0,87,118,15,103
UTTAR PRADESH,CAUSING DEATH BY NEGLIGENCE (SECTION 304-A IPC),623,11837,662,509,11289,25164,36453,325,30280,5848,3040,2808
UTTARAKHAND,CAUSING DEATH BY NEGLIGENCE (SECTION 304-A IPC),16,531,0,18,529,1852,2381,30,1773,578,498,80
WEST BENGAL,CAUSING DEATH BY NEGLIGENCE (SECTION 304-A IPC),1088,3704,517,870,3405,12549,15954,74,14712,1168,84,1084
TOTAL (STATES),CAUSING DEATH BY NEGLIGENCE (SECTION 304-A IPC),25744,86494,2788,24255,85195,339480,424675,4598,361954,58123,13606,44517
A & N ISLANDS,CAUSING DEATH BY NEGLIGENCE (SECTION 304-A IPC),1,5,0,3,3,36,39,0,37,2,0,2
CHANDIGARH,CAUSING DEATH BY NEGLIGENCE (SECTION 304-A IPC),6,5,0,3,8,52,60,0,53,7,1,6
D & N HAVELI,CAUSING DEATH BY NEGLIGENCE (SECTION 304-A IPC),9,37,0,7,39,102,141,0,131,10,0,10
DAMAN & DIU,CAUSING DEATH BY NEGLIGENCE (SECTION 304-A IPC),8,31,0,8,31,98,129,0,106,23,3,20
DELHI,CAUSING DEATH BY NEGLIGENCE (SECTION 304-A IPC),243,514,36,178,543,1134,1677,0,1059,618,304,314
LAKSHADWEEP,CAUSING DEATH BY NEGLIGENCE (SECTION 304-A IPC),0,0,0,0,0,0,0,0,0,0,0,0
PUDUCHERRY,CAUSING DEATH BY NEGLIGENCE (SECTION 304-A IPC),89,248,0,167,170,630,800,0,680,120,103,17
TOTAL (UTs),CAUSING DEATH BY NEGLIGENCE (SECTION 304-A IPC),356,840,36,366,794,2052,2846,0,2066,780,411,369
TOTAL (ALL-INDIA),CAUSING DEATH BY NEGLIGENCE (SECTION 304-A IPC),26100,87334,2824,24621,85989,341532,427521,4598,364020,58903,14017,44886
ANDHRA PRADESH,OTHER IPC CRIMES,17432,61931,0,17417,61946,102090,164036,16142,98930,48964,17832,31132
ARUNACHAL PRADESH,OTHER IPC CRIMES,452,743,252,546,397,7427,7824,75,7610,139,70,69
ASSAM,OTHER IPC CRIMES,13171,18599,8514,13367,9889,16024,25913,544,17407,7962,944,7018
BIHAR,OTHER IPC CRIMES,34261,65071,958,19185,79189,532877,612066,5631,560069,46366,6280,40086
CHHATTISGARH,OTHER IPC CRIMES,968,28384,35,1198,28119,82746,110865,3522,80631,26712,16473,10239
GOA,OTHER IPC CRIMES,607,1054,51,734,876,4270,5146,10,4533,603,183,420
GUJARAT,OTHER IPC CRIMES,6937,92325,1,8448,90813,673136,763949,1794,696112,66043,25731,40312
HARYANA,OTHER IPC CRIMES,3858,25483,0,3412,25929,86022,111951,0,81180,30771,11014,19757
HIMACHAL PRADESH,OTHER IPC CRIMES,1156,9133,12,2116,8161,65949,74110,1147,67429,5534,1226,4308
JAMMU & KASHMIR,OTHER IPC CRIMES,45,19773,0,50,19768,56613,76381,6127,55726,14528,6222,8306
JHARKHAND,OTHER IPC CRIMES,9855,19670,0,10798,18727,34553,53280,480,35022,17778,3521,14257
KARNATAKA,OTHER IPC CRIMES,8998,58570,1423,9119,57026,86087,143113,3467,84320,55326,25749,29577
KERALA,OTHER IPC CRIMES,8207,105496,0,8623,105080,225422,330502,1666,250329,78507,63922,14585
MADHYA PRADESH,OTHER IPC CRIMES,1444,182439,1,1120,182762,509984,692746,65389,511692,115665,61402,54263
MAHARASHTRA,OTHER IPC CRIMES,18591,58364,115,19151,57689,541391,599080,13959,535473,49648,4035,45613
MANIPUR,OTHER IPC CRIMES,710,546,507,728,21,1137,1158,2,1124,32,21,11
MEGHALAYA,OTHER IPC CRIMES,519,604,73,569,481,3017,3498,14,3419,65,29,36
MIZORAM,OTHER IPC CRIMES,55,326,1,103,277,237,514,8,253,253,207,46
NAGALAND,OTHER IPC CRIMES,272,336,109,188,311,144,455,6,116,333,292,41
ODISHA,OTHER IPC CRIMES,2051,29068,111,3735,27273,224170,251443,0,229556,21887,1721,20166
PUNJAB,OTHER IPC CRIMES,5954,13408,422,8573,10367,37587,47954,60,36891,11003,4922,6081
RAJASTHAN,OTHER IPC CRIMES,996,94235,0,941,94290,439157,533447,15163,445555,72729,49183,23546
SIKKIM,OTHER IPC CRIMES,150,142,65,132,95,274,369,45,162,162,60,102
TAMIL NADU,OTHER IPC CRIMES,39139,122153,2593,46719,111980,114579,226559,85,119235,107239,66428,40811
TRIPURA,OTHER IPC CRIMES,457,1685,163,451,1528,2263,3791,0,1289,2502,361,2141
UTTAR PRADESH,OTHER IPC CRIMES,11475,143470,35656,12979,106310,208757,315067,12641,248289,54137,29490,24647
UTTARAKHAND,OTHER IPC CRIMES,287,3018,109,388,2808,13155,15963,234,11773,3956,2984,972
WEST BENGAL,OTHER IPC CRIMES,24467,67885,5512,26440,60400,288664,349064,2419,327232,19413,2394,17019
TOTAL (STATES),OTHER IPC CRIMES,212514,1223911,56683,217230,1162512,4357732,5520244,150630,4511357,858257,402696,455561
A & N ISLANDS,OTHER IPC CRIMES,65,332,0,48,349,5175,5524,0,5187,337,240,97
CHANDIGARH,OTHER IPC CRIMES,508,1307,32,278,1505,3649,5154,0,4162,992,422,570
D & N HAVELI,OTHER IPC CRIMES,49,135,0,37,147,1537,1684,0,1544,140,18,122
DAMAN & DIU,OTHER IPC CRIMES,26,53,0,45,34,260,294,0,275,19,2,17
DELHI,OTHER IPC CRIMES,13056,17350,1000,13881,15525,39587,55112,0,38670,16442,8857,7585
LAKSHADWEEP,OTHER IPC CRIMES,36,21,0,55,2,120,122,0,80,42,15,27
PUDUCHERRY,OTHER IPC CRIMES,565,1964,11,746,1772,2337,4109,2,2655,1452,1381,71
TOTAL (UTs),OTHER IPC CRIMES,14305,21162,1043,15090,19334,52665,71999,2,52573,19424,10935,8489
TOTAL (ALL-INDIA),OTHER IPC CRIMES,226819,1245073,57726,232320,1181846,4410397,5592243,150632,4563930,877681,413631,464050
ANDHRA PRADESH,TOTAL COGNIZABLE IPC CRIMES,70735,246395,17,74165,242948,456873,699821,49677,466997,183147,48564,134583
ARUNACHAL PRADESH,TOTAL COGNIZABLE IPC CRIMES,1906,2483,750,2186,1453,22527,23980,154,23262,564,236,328
ASSAM,TOTAL COGNIZABLE IPC CRIMES,71641,72795,34584,70303,39549,126270,165819,1013,133014,31792,3829,27963
BIHAR,TOTAL COGNIZABLE IPC CRIMES,126882,264570,5284,105221,280947,1545413,1826360,19288,1656666,150406,16944,133462
CHHATTISGARH,TOTAL COGNIZABLE IPC CRIMES,3805,73321,35,3908,73183,273346,346529,18244,267531,60754,27696,33058
GOA,TOTAL COGNIZABLE IPC CRIMES,2275,3354,186,3084,2359,14296,16655,50,14700,1905,380,1525
GUJARAT,TOTAL COGNIZABLE IPC CRIMES,15571,182284,55,17408,180392,1609658,1790050,3989,1672345,113716,28648,85068
HARYANA,TOTAL COGNIZABLE IPC CRIMES,10869,65108,0,8617,67360,253721,321081,298,245808,74975,21375,53600
HIMACHAL PRADESH,TOTAL COGNIZABLE IPC CRIMES,2896,16726,82,3900,15640,115776,131416,2343,116995,12078,2114,9964
JAMMU & KASHMIR,TOTAL COGNIZABLE IPC CRIMES,302,40358,0,335,40325,186117,226442,10048,182627,33767,7978,25789
JHARKHAND,TOTAL COGNIZABLE IPC CRIMES,27524,53770,8,31581,49705,95421,145126,1831,98757,44538,9802,34736
KARNATAKA,TOTAL COGNIZABLE IPC CRIMES,25855,164835,4078,26218,160394,335740,496134,12902,342293,140939,30010,110929
KERALA,TOTAL COGNIZABLE IPC CRIMES,33218,209344,58,32325,210179,662591,872770,6484,723675,142611,75926,66685
MADHYA PRADESH,TOTAL COGNIZABLE IPC CRIMES,3656,343857,1,3223,344289,1196960,1541249,105846,1209723,225680,100616,125064
MAHARASHTRA,TOTAL COGNIZABLE IPC CRIMES,100486,309672,3289,106369,300500,2860753,3161253,40779,2900300,220174,15043,205131
MANIPUR,TOTAL COGNIZABLE IPC CRIMES,2505,1797,1551,2651,100,3079,3179,7,3097,75,52,23
MEGHALAYA,TOTAL COGNIZABLE IPC CRIMES,3978,1984,339,4183,1440,13194,14634,37,14294,303,109,194
MIZORAM,TOTAL COGNIZABLE IPC CRIMES,254,1721,2,478,1495,1484,2979,12,1449,1518,1337,181
NAGALAND,TOTAL COGNIZABLE IPC CRIMES,708,1010,193,485,1040,679,1719,28,589,1102,900,202
ODISHA,TOTAL COGNIZABLE IPC CRIMES,9168,96249,334,11426,93657,586663,680320,0,616200,64120,5908,58212
PUNJAB,TOTAL COGNIZABLE IPC CRIMES,27515,46632,1791,35068,37288,147533,184821,95,147571,37155,13835,23320
RAJASTHAN,TOTAL COGNIZABLE IPC CRIMES,1760,177833,6,1812,177775,933188,1110963,34382,934096,142485,86172,56313
SIKKIM,TOTAL COGNIZABLE IPC CRIMES,349,637,158,411,417,945,1362,75,767,520,236,284
TAMIL NADU,TOTAL COGNIZABLE IPC CRIMES,100827,232414,4963,109597,218681,360741,579422,191,393190,186041,94690,91351
TRIPURA,TOTAL COGNIZABLE IPC CRIMES,2782,7260,953,1677,7412,8540,15952,0,8601,7351,1100,6251
UTTAR PRADESH,TOTAL COGNIZABLE IPC CRIMES,46775,412811,97572,61577,300437,860548,1160985,24879,970606,165500,85893,79607
UTTARAKHAND,TOTAL COGNIZABLE IPC CRIMES,1770,11110,243,1803,10834,49450,60284,2220,45569,12495,8504,3991
WEST BENGAL,TOTAL COGNIZABLE IPC CRIMES,82872,177722,20479,82092,158023,879612,1037635,5633,967082,64920,5553,59367
TOTAL (STATES),TOTAL COGNIZABLE IPC CRIMES,778884,3218052,177011,802103,3017822,13601118,16618940,340505,14157804,2120631,693450,1427181
A & N ISLANDS,TOTAL COGNIZABLE IPC CRIMES,393,683,0,353,723,9852,10575,0,10034,541,297,244
CHANDIGARH,TOTAL COGNIZABLE IPC CRIMES,1646,3702,136,906,4306,10062,14368,0,11696,2672,1252,1420
D & N HAVELI,TOTAL COGNIZABLE IPC CRIMES,305,529,0,243,591,4762,5353,0,4875,478,43,435
DAMAN & DIU,TOTAL COGNIZABLE IPC CRIMES,167,387,3,146,405,1404,1809,22,1548,239,23,216
DELHI,TOTAL COGNIZABLE IPC CRIMES,24605,40775,3309,25229,36842,218910,255752,0,215839,39913,20598,19315
LAKSHADWEEP,TOTAL COGNIZABLE IPC CRIMES,252,30,27,247,8,192,200,2,120,78,32,46
PUDUCHERRY,TOTAL COGNIZABLE IPC CRIMES,1174,5858,11,2064,4957,11476,16433,46,13287,3100,2086,1014
TOTAL (UTs),TOTAL COGNIZABLE IPC CRIMES,28542,51964,3486,29188,47832,256658,304490,70,257399,47021,24331,22690
TOTAL (ALL-INDIA),TOTAL COGNIZABLE IPC CRIMES,807426,3270016,180497,831291,3065654,13857776,16923430,340575,14415203,2167652,717781,1449871
