states_uts,crime_head,year,18_and_above_and_below_30_years_male,18_and_above_and_below_30_years_female,18_and_above_and_below_30_years_total,30_and_above_and_below_45_years_male,30_and_above_and_below_45_years_female,30_and_above_and_below_45_years_total,45_and_above_and_below_60_years_male,45_and_above_and_below_60_years_female,45_and_above_and_below_60_years_total,60_years_and_above_male,60_years_and_above_female,60_years_and_above_total,total_male,total_female,total_persons_arrested_by_age_and_sex
Andhra Pradesh,"1 - Arms Act, 1959",2014,73,3,76,155,0,155,27,0,27,6,0,6,261,3,264
Andhra Pradesh,"2 - Narcotic Drugs & Psychotropic Substances Act, 1985",2014,303,14,317,310,15,325,118,8,126,7,3,10,738,40,778
Andhra Pradesh,"3 - Gambling Act, 1867",2014,12473,0,12473,7860,0,7860,3672,0,3672,114,0,114,24119,0,24119
Andhra Pradesh,"4 - Excise Act, 1944",2014,2142,38,2180,2270,61,2331,953,54,1007,232,2,234,5597,155,5752
Andhra Pradesh,5 - Prohibition Act,2014,300,2,302,968,26,994,426,18,444,12,0,12,1706,46,1752
Andhra Pradesh,6 - Explosives and Explosive Substances Act,2014,55,0,55,116,2,118,38,0,38,5,0,5,214,2,216
Andhra Pradesh,"7 - Immoral Traffic (Prevention) Act, 1956",2014,132,79,211,186,109,295,54,31,85,6,7,13,378,226,604
Andhra Pradesh,7.1 - Under Section 5,2014,34,15,49,16,9,25,10,0,10,0,0,0,60,24,84
Andhra Pradesh,7.2 - Under Section 6,2014,0,0,0,0,0,0,0,0,0,0,0,0,0,0,0
Andhra Pradesh,7.3 - Under Section 7,2014,0,0,0,0,0,0,0,0,0,0,0,0,0,0,0
Andhra Pradesh,7.4 - Under Section 8,2014,1,0,1,7,2,9,0,0,0,0,0,0,8,2,10
Andhra Pradesh,7.5 - Other Sections under ITP Act,2014,97,64,161,163,98,261,44,31,75,6,7,13,310,200,510
Andhra Pradesh,"8 - Indian Railways Act, 1989",2014,0,0,0,1,0,1,1,0,1,0,0,0,2,0,2
Andhra Pradesh,"9 - Registration of Foreigners Act, 1939",2014,1,0,1,1,0,1,16,0,16,0,0,0,18,0,18
Andhra Pradesh,"10 - Protection of Civil Rights Act, 1955",2014,0,0,0,2,0,2,2,0,2,0,0,0,4,0,4
Andhra Pradesh,10.1 - PCR Act for crimes committed against SCs,2014,0,0,0,2,0,2,2,0,2,0,0,0,4,0,4
Andhra Pradesh,10.2 - PCR Act for crimes committed against STs,2014,0,0,0,0,0,0,0,0,0,0,0,0,0,0,0
Andhra Pradesh,10.3 - PCR Act for crimes committed against Others,2014,0,0,0,0,0,0,0,0,0,0,0,0,0,0,0
Andhra Pradesh,"11 - Passport Act, 1967",2014,4,2,6,8,6,14,0,0,0,0,0,0,12,8,20
Andhra Pradesh,"12 - Essential Commodities Act, 1955",2014,98,0,98,169,0,169,98,2,100,4,0,4,369,2,371
Andhra Pradesh,"13 - Antiquities & Art Treasures Act, 1972",2014,1,0,1,4,0,4,1,0,1,0,0,0,6,0,6
Andhra Pradesh,"14 - Dowry Prohibition Act, 1961",2014,333,7,340,311,13,324,151,20,171,0,0,0,795,40,835
Andhra Pradesh,"15 - Indecent Representation of Women (Prohibition) Act, 1986",2014,8,0,8,17,0,17,0,0,0,0,0,0,25,0,25
Andhra Pradesh,"16 - Copyright Act, 1957",2014,184,0,184,241,0,241,60,0,60,0,0,0,485,0,485
Andhra Pradesh,17 - Commission of Sati Prevention Act 1987,2014,0,0,0,0,0,0,0,0,0,0,0,0,0,0,0
Andhra Pradesh,"18 - SC/ST (Prevention of Atrocities) Act, 1989)",2014,119,3,122,236,19,255,74,2,76,3,0,3,432,24,456
Andhra Pradesh,18.1 - POA Act for crimes committed against SCs,2014,100,3,103,190,17,207,63,2,65,3,0,3,356,22,378
Andhra Pradesh,18.2 - POA Act for crimes committed against STs,2014,19,0,19,46,2,48,11,0,11,0,0,0,76,2,78
Andhra Pradesh,"19 - Forest Act, 1927",2014,58,0,58,49,0,49,5,0,5,0,0,0,112,0,112
Andhra Pradesh,"20 - Prohibition of Child Marriage Act, 2006",2014,4,0,4,18,3,21,5,2,7,2,0,2,29,5,34
Andhra Pradesh,"21 - Protection of Women from Domestic Violence Act, 2005",2014,0,0,0,0,0,0,0,0,0,0,0,0,0,0,0
Andhra Pradesh,"22 - Information Technology Act, 2000",2014,45,0,45,52,2,54,20,0,20,0,0,0,117,2,119
Andhra Pradesh,"23 - Official Secrets Act, 1923",2014,0,0,0,0,0,0,0,0,0,0,0,0,0,0,0
Andhra Pradesh,"24 - Electricity Act, 2003",2014,2,0,2,2,0,2,1,0,1,0,0,0,5,0,5
Andhra Pradesh,"25 - Wildlife Protection Act, 1972",2014,3,0,3,22,0,22,8,0,8,0,0,0,33,0,33
Andhra Pradesh,"26 - Bonded Labour System (Abolition) Act, 1976",2014,0,0,0,0,0,0,0,0,0,0,0,0,0,0,0
Andhra Pradesh,26.1 - Against SCs,2014,0,0,0,0,0,0,0,0,0,0,0,0,0,0,0
Andhra Pradesh,26.2 - Against STs,2014,0,0,0,0,0,0,0,0,0,0,0,0,0,0,0
Andhra Pradesh,26.3 - Against others,2014,0,0,0,0,0,0,0,0,0,0,0,0,0,0,0
Andhra Pradesh,"27 - Environmental (Protection) Act, 1986",2014,0,0,0,0,0,0,0,0,0,0,0,0,0,0,0
Andhra Pradesh,"28 - Air (Prevention & Control of Pollution) Act, 1981",2014,0,0,0,0,0,0,0,0,0,0,0,0,0,0,0
Andhra Pradesh,"29 - Water (Prevention & Control of Pollution) Act, 1974(as amended in 1988)",2014,0,0,0,0,0,0,0,0,0,0,0,0,0,0,0
Andhra Pradesh,"30 - National Security Act, 1980",2014,0,0,0,0,0,0,0,0,0,0,0,0,0,0,0
Andhra Pradesh,"31 - Unlawful Activities (Prevention) Act, 1967",2014,0,0,0,0,0,0,0,0,0,0,0,0,0,0,0
Andhra Pradesh,"32 - Young Persons (Harmful Publications) Act, 1956",2014,0,0,0,0,0,0,0,0,0,0,0,0,0,0,0
Andhra Pradesh,"33 - Railway Property (Unlawful Possession) Act, 1966",2014,0,0,0,0,0,0,0,0,0,0,0,0,0,0,0
Andhra Pradesh,"34 - Prevention of Damage to Public Property Act, 1984",2014,14,0,14,19,1,20,5,0,5,0,0,0,38,1,39
Andhra Pradesh,"35 - Transplantation of Human Organs Act, 1994",2014,0,0,0,0,0,0,0,0,0,0,0,0,0,0,0
Andhra Pradesh,"36 - Trade Marks Act, 1999",2014,0,0,0,0,0,0,0,0,0,0,0,0,0,0,0
Andhra Pradesh,"37 - Prevention of Insults to National Honour Act, 1971",2014,0,0,0,0,0,0,0,0,0,0,0,0,0,0,0
Andhra Pradesh,"38 - State Emblem (Prohibition of Improper Use) Act, 2005",2014,0,0,0,0,0,0,0,0,0,0,0,0,0,0,0
Andhra Pradesh,"39 - Lotteries (Regulation) Act, 1998",2014,27,0,27,63,0,63,25,0,25,0,0,0,115,0,115
Andhra Pradesh,"40 - Citizenship Act, 1955",2014,0,0,0,0,0,0,0,0,0,0,0,0,0,0,0
Andhra Pradesh,"41 - Foreigners Act, 1946",2014,0,0,0,2,0,2,0,0,0,0,0,0,2,0,2
Andhra Pradesh,"42 - Place of Worship (Special Provisions) Act, 1991",2014,0,0,0,0,0,0,0,0,0,0,0,0,0,0,0
Andhra Pradesh,"43 - Religious Institution (Prevention of Misuse) Act, 1988",2014,0,0,0,0,0,0,0,0,0,0,0,0,0,0,0
Andhra Pradesh,"44 - Representation of People Act, 1951",2014,18,0,18,23,0,23,6,0,6,0,0,0,47,0,47
Andhra Pradesh,"45 - Emigration Act, 1983",2014,0,0,0,1,0,1,0,0,0,0,0,0,1,0,1
Andhra Pradesh,"46 - Juvenile Justice (Care and Protection of Children) Act, 2000",2014,0,0,0,2,1,3,0,0,0,0,0,0,2,1,3
Andhra Pradesh,"47 - Infant Substitutes Regulation Act, 2003",2014,0,0,0,0,0,0,0,0,0,0,0,0,0,0,0
Andhra Pradesh,"48 - Anti-Hijacking Act, 1982",2014,0,0,0,0,0,0,0,0,0,0,0,0,0,0,0
Andhra Pradesh,"49 - Atomic Energy Act, 1962",2014,0,0,0,0,0,0,0,0,0,0,0,0,0,0,0
Andhra Pradesh,"50 - Weapons of Mass Destruction (Proh. of Unlawful Activities) Act, 2005",2014,0,0,0,0,0,0,0,0,0,0,0,0,0,0,0
Andhra Pradesh,"51 - Suppression of Unlawful Acts against Safety of Civil Aviation Act, 1982",2014,0,0,0,0,0,0,0,0,0,0,0,0,0,0,0
Andhra Pradesh,"52 - Safety of Maritime Navigation Act, 2002",2014,0,0,0,0,0,0,0,0,0,0,0,0,0,0,0
Andhra Pradesh,"53 - Manual Scavengers and Construction of Dry Latrines (P) Act, 1993",2014,0,0,0,0,0,0,0,0,0,0,0,0,0,0,0
Andhra Pradesh,"54 - Pre-Natal Diagnostic Techniques (Reg and Prev of Misuse) Act, 1994",2014,0,0,0,0,0,0,0,0,0,0,0,0,0,0,0
Andhra Pradesh,"55 - The Maritime Zones of India (Reg of Fishing by Foreign Vessels) Act, 1981",2014,0,0,0,0,0,0,0,0,0,0,0,0,0,0,0
Andhra Pradesh,56 - Other SLL crimes,2014,707,28,735,1398,42,1440,433,7,440,78,0,78,2616,77,2693
Andhra Pradesh,57 - Total Cognizable SLL crimes,2014,17104,176,17280,14506,300,14806,6199,144,6343,469,12,481,38278,632,38910
Arunachal Pradesh,"1 - Arms Act, 1959",2014,19,0,19,9,0,9,1,0,1,0,0,0,29,0,29
Arunachal Pradesh,"2 - Narcotic Drugs & Psychotropic Substances Act, 1985",2014,68,9,77,32,6,38,1,0,1,1,1,2,102,16,118
Arunachal Pradesh,"3 - Gambling Act, 1867",2014,9,0,9,3,2,5,0,1,1,0,0,0,12,3,15
Arunachal Pradesh,"4 - Excise Act, 1944",2014,0,0,0,0,1,1,0,0,0,0,0,0,0,1,1
Arunachal Pradesh,5 - Prohibition Act,2014,5,0,5,0,0,0,0,0,0,0,0,0,5,0,5
Arunachal Pradesh,6 - Explosives and Explosive Substances Act,2014,0,0,0,3,0,3,0,0,0,0,0,0,3,0,3
Arunachal Pradesh,"7 - Immoral Traffic (Prevention) Act, 1956",2014,1,5,6,0,1,1,1,0,1,0,0,0,2,6,8
Arunachal Pradesh,7.1 - Under Section 5,2014,0,0,0,0,0,0,0,0,0,0,0,0,0,0,0
Arunachal Pradesh,7.2 - Under Section 6,2014,0,0,0,0,0,0,0,0,0,0,0,0,0,0,0
Arunachal Pradesh,7.3 - Under Section 7,2014,1,5,6,0,1,1,1,0,1,0,0,0,2,6,8
Arunachal Pradesh,7.4 - Under Section 8,2014,0,0,0,0,0,0,0,0,0,0,0,0,0,0,0
Arunachal Pradesh,7.5 - Other Sections under ITP Act,2014,0,0,0,0,0,0,0,0,0,0,0,0,0,0,0
Arunachal Pradesh,"8 - Indian Railways Act, 1989",2014,0,0,0,0,0,0,0,0,0,0,0,0,0,0,0
Arunachal Pradesh,"9 - Registration of Foreigners Act, 1939",2014,9,0,9,3,0,3,0,0,0,0,0,0,12,0,12
Arunachal Pradesh,"10 - Protection of Civil Rights Act, 1955",2014,0,0,0,0,0,0,0,0,0,0,0,0,0,0,0
Arunachal Pradesh,10.1 - PCR Act for crimes committed against SCs,2014,0,0,0,0,0,0,0,0,0,0,0,0,0,0,0
Arunachal Pradesh,10.2 - PCR Act for crimes committed against STs,2014,0,0,0,0,0,0,0,0,0,0,0,0,0,0,0
Arunachal Pradesh,10.3 - PCR Act for crimes committed against Others,2014,0,0,0,0,0,0,0,0,0,0,0,0,0,0,0
Arunachal Pradesh,"11 - Passport Act, 1967",2014,1,0,1,0,0,0,0,0,0,0,0,0,1,0,1
Arunachal Pradesh,"12 - Essential Commodities Act, 1955",2014,0,0,0,0,0,0,0,0,0,0,0,0,0,0,0
Arunachal Pradesh,"13 - Antiquities & Art Treasures Act, 1972",2014,0,0,0,0,0,0,0,0,0,0,0,0,0,0,0
Arunachal Pradesh,"14 - Dowry Prohibition Act, 1961",2014,0,0,0,0,0,0,0,0,0,0,0,0,0,0,0
Arunachal Pradesh,"15 - Indecent Representation of Women (Prohibition) Act, 1986",2014,0,0,0,0,0,0,0,0,0,0,0,0,0,0,0
Arunachal Pradesh,"16 - Copyright Act, 1957",2014,0,0,0,0,0,0,0,0,0,0,0,0,0,0,0
Arunachal Pradesh,17 - Commission of Sati Prevention Act 1987,2014,0,0,0,0,0,0,0,0,0,0,0,0,0,0,0
Arunachal Pradesh,"18 - SC/ST (Prevention of Atrocities) Act, 1989)",2014,0,0,0,0,0,0,0,0,0,0,0,0,0,0,0
Arunachal Pradesh,18.1 - POA Act for crimes committed against SCs,2014,0,0,0,0,0,0,0,0,0,0,0,0,0,0,0
Arunachal Pradesh,18.2 - POA Act for crimes committed against STs,2014,0,0,0,0,0,0,0,0,0,0,0,0,0,0,0
Arunachal Pradesh,"19 - Forest Act, 1927",2014,5,0,5,8,0,8,5,0,5,0,0,0,18,0,18
Arunachal Pradesh,"20 - Prohibition of Child Marriage Act, 2006",2014,0,0,0,0,0,0,0,0,0,0,0,0,0,0,0
Arunachal Pradesh,"21 - Protection of Women from Domestic Violence Act, 2005",2014,0,0,0,0,0,0,0,0,0,0,0,0,0,0,0
Arunachal Pradesh,"22 - Information Technology Act, 2000",2014,1,0,1,0,0,0,0,0,0,0,0,0,1,0,1
Arunachal Pradesh,"23 - Official Secrets Act, 1923",2014,0,0,0,0,0,0,0,0,0,0,0,0,0,0,0
Arunachal Pradesh,"24 - Electricity Act, 2003",2014,0,0,0,0,0,0,0,0,0,0,0,0,0,0,0
Arunachal Pradesh,"25 - Wildlife Protection Act, 1972",2014,2,2,4,1,0,1,0,0,0,0,0,0,3,2,5
Arunachal Pradesh,"26 - Bonded Labour System (Abolition) Act, 1976",2014,0,0,0,0,0,0,0,0,0,0,0,0,0,0,0
Arunachal Pradesh,26.1 - Against SCs,2014,0,0,0,0,0,0,0,0,0,0,0,0,0,0,0
Arunachal Pradesh,26.2 - Against STs,2014,0,0,0,0,0,0,0,0,0,0,0,0,0,0,0
Arunachal Pradesh,26.3 - Against others,2014,0,0,0,0,0,0,0,0,0,0,0,0,0,0,0
Arunachal Pradesh,"27 - Environmental (Protection) Act, 1986",2014,0,0,0,0,0,0,0,0,0,0,0,0,0,0,0
Arunachal Pradesh,"28 - Air (Prevention & Control of Pollution) Act, 1981",2014,0,0,0,0,0,0,0,0,0,0,0,0,0,0,0
Arunachal Pradesh,"29 - Water (Prevention & Control of Pollution) Act, 1974(as amended in 1988)",2014,0,0,0,0,0,0,0,0,0,0,0,0,0,0,0
Arunachal Pradesh,"30 - National Security Act, 1980",2014,0,0,0,0,0,0,0,0,0,0,0,0,0,0,0
Arunachal Pradesh,"31 - Unlawful Activities (Prevention) Act, 1967",2014,0,0,0,0,0,0,0,0,0,0,0,0,0,0,0
Arunachal Pradesh,"32 - Young Persons (Harmful Publications) Act, 1956",2014,0,0,0,0,0,0,0,0,0,0,0,0,0,0,0
Arunachal Pradesh,"33 - Railway Property (Unlawful Possession) Act, 1966",2014,0,0,0,0,0,0,0,0,0,0,0,0,0,0,0
Arunachal Pradesh,"34 - Prevention of Damage to Public Property Act, 1984",2014,0,0,0,0,1,1,0,0,0,0,0,0,0,1,1
Arunachal Pradesh,"35 - Transplantation of Human Organs Act, 1994",2014,0,0,0,0,0,0,0,0,0,0,0,0,0,0,0
Arunachal Pradesh,"36 - Trade Marks Act, 1999",2014,0,0,0,0,0,0,0,0,0,0,0,0,0,0,0
Arunachal Pradesh,"37 - Prevention of Insults to National Honour Act, 1971",2014,0,0,0,0,0,0,0,0,0,0,0,0,0,0,0
Arunachal Pradesh,"38 - State Emblem (Prohibition of Improper Use) Act, 2005",2014,0,0,0,0,0,0,0,0,0,0,0,0,0,0,0
Arunachal Pradesh,"39 - Lotteries (Regulation) Act, 1998",2014,0,0,0,0,0,0,0,0,0,0,0,0,0,0,0
Arunachal Pradesh,"40 - Citizenship Act, 1955",2014,0,0,0,0,0,0,0,0,0,0,0,0,0,0,0
Arunachal Pradesh,"41 - Foreigners Act, 1946",2014,1,0,1,0,0,0,0,0,0,0,0,0,1,0,1
Arunachal Pradesh,"42 - Place of Worship (Special Provisions) Act, 1991",2014,0,0,0,0,0,0,0,0,0,0,0,0,0,0,0
Arunachal Pradesh,"43 - Religious Institution (Prevention of Misuse) Act, 1988",2014,0,0,0,0,0,0,0,0,0,0,0,0,0,0,0
Arunachal Pradesh,"44 - Representation of People Act, 1951",2014,0,0,0,0,0,0,0,0,0,0,0,0,0,0,0
Arunachal Pradesh,"45 - Emigration Act, 1983",2014,0,0,0,0,0,0,0,0,0,0,0,0,0,0,0
Arunachal Pradesh,"46 - Juvenile Justice (Care and Protection of Children) Act, 2000",2014,0,0,0,0,0,0,0,0,0,0,0,0,0,0,0
Arunachal Pradesh,"47 - Infant Substitutes Regulation Act, 2003",2014,0,0,0,0,0,0,0,0,0,0,0,0,0,0,0
Arunachal Pradesh,"48 - Anti-Hijacking Act, 1982",2014,0,0,0,0,0,0,0,0,0,0,0,0,0,0,0
Arunachal Pradesh,"49 - Atomic Energy Act, 1962",2014,0,0,0,0,0,0,0,0,0,0,0,0,0,0,0
Arunachal Pradesh,"50 - Weapons of Mass Destruction (Proh. of Unlawful Activities) Act, 2005",2014,0,0,0,0,0,0,0,0,0,0,0,0,0,0,0
Arunachal Pradesh,"51 - Suppression of Unlawful Acts against Safety of Civil Aviation Act, 1982",2014,0,0,0,0,0,0,0,0,0,0,0,0,0,0,0
Arunachal Pradesh,"52 - Safety of Maritime Navigation Act, 2002",2014,0,0,0,0,0,0,0,0,0,0,0,0,0,0,0
Arunachal Pradesh,"53 - Manual Scavengers and Construction of Dry Latrines (P) Act, 1993",2014,0,0,0,0,0,0,0,0,0,0,0,0,0,0,0
Arunachal Pradesh,"54 - Pre-Natal Diagnostic Techniques (Reg and Prev of Misuse) Act, 1994",2014,0,0,0,0,0,0,0,0,0,0,0,0,0,0,0
Arunachal Pradesh,"55 - The Maritime Zones of India (Reg of Fishing by Foreign Vessels) Act, 1981",2014,0,0,0,0,0,0,0,0,0,0,0,0,0,0,0
Arunachal Pradesh,56 - Other SLL crimes,2014,18,1,19,7,4,11,0,0,0,0,0,0,25,5,30
Arunachal Pradesh,57 - Total Cognizable SLL crimes,2014,139,17,156,66,15,81,8,1,9,1,1,2,214,34,248
Assam,"1 - Arms Act, 1959",2014,419,0,419,639,0,639,84,0,84,19,0,19,1161,0,1161
Assam,"2 - Narcotic Drugs & Psychotropic Substances Act, 1985",2014,99,2,101,260,8,268,13,0,13,1,0,1,373,10,383
Assam,"3 - Gambling Act, 1867",2014,21,0,21,104,0,104,38,0,38,20,0,20,183,0,183
Assam,"4 - Excise Act, 1944",2014,4,0,4,22,0,22,0,0,0,0,0,0,26,0,26
Assam,5 - Prohibition Act,2014,0,0,0,0,0,0,0,0,0,0,0,0,0,0,0
Assam,6 - Explosives and Explosive Substances Act,2014,60,0,60,127,0,127,12,0,12,0,0,0,199,0,199
Assam,"7 - Immoral Traffic (Prevention) Act, 1956",2014,14,0,14,25,0,25,1,0,1,0,0,0,40,0,40
Assam,7.1 - Under Section 5,2014,2,0,2,4,0,4,1,0,1,0,0,0,7,0,7
Assam,7.2 - Under Section 6,2014,3,0,3,1,0,1,0,0,0,0,0,0,4,0,4
Assam,7.3 - Under Section 7,2014,0,0,0,2,0,2,0,0,0,0,0,0,2,0,2
Assam,7.4 - Under Section 8,2014,0,0,0,0,0,0,0,0,0,0,0,0,0,0,0
Assam,7.5 - Other Sections under ITP Act,2014,9,0,9,18,0,18,0,0,0,0,0,0,27,0,27
Assam,"8 - Indian Railways Act, 1989",2014,6,0,6,21,0,21,3,0,3,0,0,0,30,0,30
Assam,"9 - Registration of Foreigners Act, 1939",2014,2,0,2,10,0,10,3,0,3,0,0,0,15,0,15
Assam,"10 - Protection of Civil Rights Act, 1955",2014,0,0,0,0,0,0,0,0,0,0,0,0,0,0,0
Assam,10.1 - PCR Act for crimes committed against SCs,2014,0,0,0,0,0,0,0,0,0,0,0,0,0,0,0
Assam,10.2 - PCR Act for crimes committed against STs,2014,0,0,0,0,0,0,0,0,0,0,0,0,0,0,0
Assam,10.3 - PCR Act for crimes committed against Others,2014,0,0,0,0,0,0,0,0,0,0,0,0,0,0,0
Assam,"11 - Passport Act, 1967",2014,1,0,1,6,0,6,1,0,1,0,0,0,8,0,8
Assam,"12 - Essential Commodities Act, 1955",2014,3,0,3,26,0,26,5,0,5,0,0,0,34,0,34
Assam,"13 - Antiquities & Art Treasures Act, 1972",2014,0,0,0,0,0,0,0,0,0,0,0,0,0,0,0
Assam,"14 - Dowry Prohibition Act, 1961",2014,15,0,15,59,0,59,18,0,18,0,0,0,92,0,92
Assam,"15 - Indecent Representation of Women (Prohibition) Act, 1986",2014,0,0,0,0,0,0,0,0,0,0,0,0,0,0,0
Assam,"16 - Copyright Act, 1957",2014,0,0,0,3,0,3,0,0,0,0,0,0,3,0,3
Assam,17 - Commission of Sati Prevention Act 1987,2014,0,0,0,0,0,0,0,0,0,0,0,0,0,0,0
Assam,"18 - SC/ST (Prevention of Atrocities) Act, 1989)",2014,1,0,1,0,0,0,0,0,0,0,0,0,1,0,1
Assam,18.1 - POA Act for crimes committed against SCs,2014,1,0,1,0,0,0,0,0,0,0,0,0,1,0,1
Assam,18.2 - POA Act for crimes committed against STs,2014,0,0,0,0,0,0,0,0,0,0,0,0,0,0,0
Assam,"19 - Forest Act, 1927",2014,5,0,5,5,0,5,0,0,0,0,0,0,10,0,10
Assam,"20 - Prohibition of Child Marriage Act, 2006",2014,1,0,1,1,0,1,1,0,1,0,0,0,3,0,3
Assam,"21 - Protection of Women from Domestic Violence Act, 2005",2014,0,0,0,1,0,1,0,0,0,0,0,0,1,0,1
Assam,"22 - Information Technology Act, 2000",2014,113,0,113,194,0,194,44,0,44,0,0,0,351,0,351
Assam,"23 - Official Secrets Act, 1923",2014,0,0,0,0,0,0,0,0,0,0,0,0,0,0,0
Assam,"24 - Electricity Act, 2003",2014,63,0,63,64,0,64,9,0,9,0,0,0,136,0,136
Assam,"25 - Wildlife Protection Act, 1972",2014,19,0,19,46,0,46,9,0,9,0,0,0,74,0,74
Assam,"26 - Bonded Labour System (Abolition) Act, 1976",2014,0,0,0,0,0,0,0,0,0,0,0,0,0,0,0
Assam,26.1 - Against SCs,2014,0,0,0,0,0,0,0,0,0,0,0,0,0,0,0
Assam,26.2 - Against STs,2014,0,0,0,0,0,0,0,0,0,0,0,0,0,0,0
Assam,26.3 - Against others,2014,0,0,0,0,0,0,0,0,0,0,0,0,0,0,0
Assam,"27 - Environmental (Protection) Act, 1986",2014,0,0,0,0,0,0,0,0,0,0,0,0,0,0,0
Assam,"28 - Air (Prevention & Control of Pollution) Act, 1981",2014,0,0,0,0,0,0,0,0,0,0,0,0,0,0,0
Assam,"29 - Water (Prevention & Control of Pollution) Act, 1974(as amended in 1988)",2014,0,0,0,0,0,0,0,0,0,0,0,0,0,0,0
Assam,"30 - National Security Act, 1980",2014,0,0,0,0,0,0,0,0,0,0,0,0,0,0,0
Assam,"31 - Unlawful Activities (Prevention) Act, 1967",2014,66,0,66,82,0,82,6,0,6,0,0,0,154,0,154
Assam,"32 - Young Persons (Harmful Publications) Act, 1956",2014,0,0,0,0,0,0,0,0,0,0,0,0,0,0,0
Assam,"33 - Railway Property (Unlawful Possession) Act, 1966",2014,1,0,1,0,0,0,0,0,0,0,0,0,1,0,1
Assam,"34 - Prevention of Damage to Public Property Act, 1984",2014,20,0,20,39,0,39,4,0,4,0,0,0,63,0,63
Assam,"35 - Transplantation of Human Organs Act, 1994",2014,0,0,0,0,0,0,0,0,0,0,0,0,0,0,0
Assam,"36 - Trade Marks Act, 1999",2014,0,0,0,0,0,0,0,0,0,0,0,0,0,0,0
Assam,"37 - Prevention of Insults to National Honour Act, 1971",2014,0,0,0,1,0,1,0,0,0,0,0,0,1,0,1
Assam,"38 - State Emblem (Prohibition of Improper Use) Act, 2005",2014,0,0,0,0,0,0,0,0,0,0,0,0,0,0,0
Assam,"39 - Lotteries (Regulation) Act, 1998",2014,0,0,0,0,0,0,0,0,0,0,0,0,0,0,0
Assam,"40 - Citizenship Act, 1955",2014,0,0,0,0,0,0,0,0,0,0,0,0,0,0,0
Assam,"41 - Foreigners Act, 1946",2014,0,0,0,14,0,14,0,0,0,0,0,0,14,0,14
Assam,"42 - Place of Worship (Special Provisions) Act, 1991",2014,0,0,0,0,0,0,0,0,0,0,0,0,0,0,0
Assam,"43 - Religious Institution (Prevention of Misuse) Act, 1988",2014,0,0,0,0,0,0,0,0,0,0,0,0,0,0,0
Assam,"44 - Representation of People Act, 1951",2014,0,0,0,0,0,0,0,0,0,0,0,0,0,0,0
Assam,"45 - Emigration Act, 1983",2014,0,0,0,6,0,6,0,0,0,0,0,0,6,0,6
Assam,"46 - Juvenile Justice (Care and Protection of Children) Act, 2000",2014,0,0,0,0,0,0,0,0,0,0,0,0,0,0,0
Assam,"47 - Infant Substitutes Regulation Act, 2003",2014,0,0,0,0,0,0,0,0,0,0,0,0,0,0,0
Assam,"48 - Anti-Hijacking Act, 1982",2014,0,0,0,0,0,0,0,0,0,0,0,0,0,0,0
Assam,"49 - Atomic Energy Act, 1962",2014,0,0,0,0,0,0,0,0,0,0,0,0,0,0,0
Assam,"50 - Weapons of Mass Destruction (Proh. of Unlawful Activities) Act, 2005",2014,0,0,0,0,0,0,0,0,0,0,0,0,0,0,0
Assam,"51 - Suppression of Unlawful Acts against Safety of Civil Aviation Act, 1982",2014,0,0,0,0,0,0,0,0,0,0,0,0,0,0,0
Assam,"52 - Safety of Maritime Navigation Act, 2002",2014,0,0,0,0,0,0,0,0,0,0,0,0,0,0,0
Assam,"53 - Manual Scavengers and Construction of Dry Latrines (P) Act, 1993",2014,0,0,0,0,0,0,0,0,0,0,0,0,0,0,0
Assam,"54 - Pre-Natal Diagnostic Techniques (Reg and Prev of Misuse) Act, 1994",2014,0,0,0,0,0,0,0,0,0,0,0,0,0,0,0
Assam,"55 - The Maritime Zones of India (Reg of Fishing by Foreign Vessels) Act, 1981",2014,0,0,0,0,0,0,0,0,0,0,0,0,0,0,0
Assam,56 - Other SLL crimes,2014,773,0,773,1604,2,1606,243,0,243,0,0,0,2620,2,2622
Assam,57 - Total Cognizable SLL crimes,2014,1706,2,1708,3359,10,3369,494,0,494,40,0,40,5599,12,5611
Bihar,"1 - Arms Act, 1959",2014,1484,0,1484,703,0,703,206,0,206,4,0,4,2397,0,2397
Bihar,"2 - Narcotic Drugs & Psychotropic Substances Act, 1985",2014,248,2,250,183,1,184,44,0,44,0,0,0,475,3,478
Bihar,"3 - Gambling Act, 1867",2014,374,0,374,280,0,280,68,0,68,0,0,0,722,0,722
Bihar,"4 - Excise Act, 1944",2014,1563,4,1567,1921,29,1950,763,0,763,41,0,41,4288,33,4321
Bihar,5 - Prohibition Act,2014,0,0,0,0,0,0,0,0,0,0,0,0,0,0,0
Bihar,6 - Explosives and Explosive Substances Act,2014,109,0,109,92,0,92,9,0,9,0,0,0,210,0,210
Bihar,"7 - Immoral Traffic (Prevention) Act, 1956",2014,37,9,46,37,8,45,5,4,9,0,0,0,79,21,100
Bihar,7.1 - Under Section 5,2014,35,9,44,35,8,43,5,4,9,0,0,0,75,21,96
Bihar,7.2 - Under Section 6,2014,1,0,1,2,0,2,0,0,0,0,0,0,3,0,3
Bihar,7.3 - Under Section 7,2014,0,0,0,0,0,0,0,0,0,0,0,0,0,0,0
Bihar,7.4 - Under Section 8,2014,0,0,0,0,0,0,0,0,0,0,0,0,0,0,0
Bihar,7.5 - Other Sections under ITP Act,2014,1,0,1,0,0,0,0,0,0,0,0,0,1,0,1
Bihar,"8 - Indian Railways Act, 1989",2014,0,0,0,0,0,0,0,0,0,0,0,0,0,0,0
Bihar,"9 - Registration of Foreigners Act, 1939",2014,0,0,0,1,0,1,0,0,0,0,0,0,1,0,1
Bihar,"10 - Protection of Civil Rights Act, 1955",2014,5,0,5,10,0,10,0,0,0,0,0,0,15,0,15
Bihar,10.1 - PCR Act for crimes committed against SCs,2014,5,0,5,10,0,10,0,0,0,0,0,0,15,0,15
Bihar,10.2 - PCR Act for crimes committed against STs,2014,0,0,0,0,0,0,0,0,0,0,0,0,0,0,0
Bihar,10.3 - PCR Act for crimes committed against Others,2014,0,0,0,0,0,0,0,0,0,0,0,0,0,0,0
Bihar,"11 - Passport Act, 1967",2014,0,0,0,0,0,0,0,0,0,0,0,0,0,0,0
Bihar,"12 - Essential Commodities Act, 1955",2014,159,0,159,335,0,335,104,0,104,6,0,6,604,0,604
Bihar,"13 - Antiquities & Art Treasures Act, 1972",2014,1,0,1,0,0,0,1,0,1,0,0,0,2,0,2
Bihar,"14 - Dowry Prohibition Act, 1961",2014,1541,131,1672,1027,101,1128,367,97,464,27,2,29,2962,331,3293
Bihar,"15 - Indecent Representation of Women (Prohibition) Act, 1986",2014,0,0,0,0,0,0,0,0,0,0,0,0,0,0,0
Bihar,"16 - Copyright Act, 1957",2014,18,0,18,18,0,18,9,0,9,0,0,0,45,0,45
Bihar,17 - Commission of Sati Prevention Act 1987,2014,0,0,0,0,0,0,0,0,0,0,0,0,0,0,0
Bihar,"18 - SC/ST (Prevention of Atrocities) Act, 1989)",2014,984,14,998,854,15,869,377,8,385,1,0,1,2216,37,2253
Bihar,18.1 - POA Act for crimes committed against SCs,2014,927,9,936,821,12,833,358,6,364,1,0,1,2107,27,2134
Bihar,18.2 - POA Act for crimes committed against STs,2014,57,5,62,33,3,36,19,2,21,0,0,0,109,10,119
Bihar,"19 - Forest Act, 1927",2014,10,0,10,20,0,20,4,0,4,1,0,1,35,0,35
Bihar,"20 - Prohibition of Child Marriage Act, 2006",2014,10,0,10,0,0,0,0,0,0,0,0,0,10,0,10
Bihar,"21 - Protection of Women from Domestic Violence Act, 2005",2014,67,0,67,45,0,45,11,0,11,0,0,0,123,0,123
Bihar,"22 - Information Technology Act, 2000",2014,63,0,63,48,0,48,0,0,0,0,0,0,111,0,111
Bihar,"23 - Official Secrets Act, 1923",2014,0,0,0,0,0,0,0,0,0,0,0,0,0,0,0
Bihar,"24 - Electricity Act, 2003",2014,370,0,370,2010,0,2010,1251,14,1265,35,0,35,3666,14,3680
Bihar,"25 - Wildlife Protection Act, 1972",2014,0,0,0,2,0,2,0,0,0,0,0,0,2,0,2
Bihar,"26 - Bonded Labour System (Abolition) Act, 1976",2014,0,0,0,2,0,2,0,0,0,0,0,0,2,0,2
Bihar,26.1 - Against SCs,2014,0,0,0,2,0,2,0,0,0,0,0,0,2,0,2
Bihar,26.2 - Against STs,2014,0,0,0,0,0,0,0,0,0,0,0,0,0,0,0
Bihar,26.3 - Against others,2014,0,0,0,0,0,0,0,0,0,0,0,0,0,0,0
Bihar,"27 - Environmental (Protection) Act, 1986",2014,0,0,0,0,0,0,0,0,0,0,0,0,0,0,0
Bihar,"28 - Air (Prevention & Control of Pollution) Act, 1981",2014,0,0,0,0,0,0,0,0,0,0,0,0,0,0,0
Bihar,"29 - Water (Prevention & Control of Pollution) Act, 1974(as amended in 1988)",2014,0,0,0,0,0,0,0,0,0,0,0,0,0,0,0
Bihar,"30 - National Security Act, 1980",2014,0,0,0,0,0,0,0,0,0,0,0,0,0,0,0
Bihar,"31 - Unlawful Activities (Prevention) Act, 1967",2014,19,0,19,42,0,42,5,0,5,0,0,0,66,0,66
Bihar,"32 - Young Persons (Harmful Publications) Act, 1956",2014,0,0,0,0,0,0,0,0,0,0,0,0,0,0,0
Bihar,"33 - Railway Property (Unlawful Possession) Act, 1966",2014,0,0,0,0,0,0,0,0,0,0,0,0,0,0,0
Bihar,"34 - Prevention of Damage to Public Property Act, 1984",2014,17,0,17,22,0,22,7,0,7,0,0,0,46,0,46
Bihar,"35 - Transplantation of Human Organs Act, 1994",2014,0,0,0,0,0,0,0,0,0,0,0,0,0,0,0
Bihar,"36 - Trade Marks Act, 1999",2014,0,0,0,1,0,1,0,0,0,0,0,0,1,0,1
Bihar,"37 - Prevention of Insults to National Honour Act, 1971",2014,0,0,0,0,0,0,0,0,0,0,0,0,0,0,0
Bihar,"38 - State Emblem (Prohibition of Improper Use) Act, 2005",2014,0,0,0,0,0,0,0,0,0,0,0,0,0,0,0
Bihar,"39 - Lotteries (Regulation) Act, 1998",2014,29,0,29,12,0,12,0,0,0,0,0,0,41,0,41
Bihar,"40 - Citizenship Act, 1955",2014,0,0,0,0,0,0,0,0,0,0,0,0,0,0,0
Bihar,"41 - Foreigners Act, 1946",2014,0,0,0,1,0,1,1,0,1,0,0,0,2,0,2
Bihar,"42 - Place of Worship (Special Provisions) Act, 1991",2014,0,0,0,0,0,0,0,0,0,0,0,0,0,0,0
Bihar,"43 - Religious Institution (Prevention of Misuse) Act, 1988",2014,0,0,0,0,0,0,0,0,0,0,0,0,0,0,0
Bihar,"44 - Representation of People Act, 1951",2014,3,0,3,15,0,15,44,0,44,0,0,0,62,0,62
Bihar,"45 - Emigration Act, 1983",2014,0,0,0,0,0,0,0,0,0,0,0,0,0,0,0
Bihar,"46 - Juvenile Justice (Care and Protection of Children) Act, 2000",2014,0,0,0,0,0,0,0,0,0,0,0,0,0,0,0
Bihar,"47 - Infant Substitutes Regulation Act, 2003",2014,0,0,0,0,0,0,0,0,0,0,0,0,0,0,0
Bihar,"48 - Anti-Hijacking Act, 1982",2014,0,0,0,0,0,0,0,0,0,0,0,0,0,0,0
Bihar,"49 - Atomic Energy Act, 1962",2014,0,0,0,0,0,0,0,0,0,0,0,0,0,0,0
Bihar,"50 - Weapons of Mass Destruction (Proh. of Unlawful Activities) Act, 2005",2014,0,0,0,0,0,0,0,0,0,0,0,0,0,0,0
Bihar,"51 - Suppression of Unlawful Acts against Safety of Civil Aviation Act, 1982",2014,0,0,0,0,0,0,0,0,0,0,0,0,0,0,0
Bihar,"52 - Safety of Maritime Navigation Act, 2002",2014,0,0,0,0,0,0,0,0,0,0,0,0,0,0,0
Bihar,"53 - Manual Scavengers and Construction of Dry Latrines (P) Act, 1993",2014,0,0,0,0,0,0,0,0,0,0,0,0,0,0,0
Bihar,"54 - Pre-Natal Diagnostic Techniques (Reg and Prev of Misuse) Act, 1994",2014,0,0,0,0,0,0,0,0,0,0,0,0,0,0,0
Bihar,"55 - The Maritime Zones of India (Reg of Fishing by Foreign Vessels) Act, 1981",2014,0,0,0,0,0,0,0,0,0,0,0,0,0,0,0
Bihar,56 - Other SLL crimes,2014,1593,78,1671,1359,61,1420,924,84,1008,97,0,97,3973,223,4196
Bihar,57 - Total Cognizable SLL crimes,2014,8704,238,8942,9040,215,9255,4200,207,4407,212,2,214,22156,662,22818
Chhattisgarh,"1 - Arms Act, 1959",2014,515,1,516,229,0,229,48,0,48,0,0,0,792,1,793
Chhattisgarh,"2 - Narcotic Drugs & Psychotropic Substances Act, 1985",2014,231,4,235,210,13,223,55,0,55,8,0,8,504,17,521
Chhattisgarh,"3 - Gambling Act, 1867",2014,13027,2,13029,10843,6,10849,3418,0,3418,324,0,324,27612,8,27620
Chhattisgarh,"4 - Excise Act, 1944",2014,5294,194,5488,5855,321,6176,2501,122,2623,229,9,238,13879,646,14525
Chhattisgarh,5 - Prohibition Act,2014,0,0,0,0,0,0,0,0,0,0,0,0,0,0,0
Chhattisgarh,6 - Explosives and Explosive Substances Act,2014,72,2,74,99,0,99,22,0,22,1,0,1,194,2,196
Chhattisgarh,"7 - Immoral Traffic (Prevention) Act, 1956",2014,11,6,17,4,4,8,0,0,0,0,0,0,15,10,25
Chhattisgarh,7.1 - Under Section 5,2014,7,3,10,1,2,3,0,0,0,0,0,0,8,5,13
Chhattisgarh,7.2 - Under Section 6,2014,0,0,0,0,0,0,0,0,0,0,0,0,0,0,0
Chhattisgarh,7.3 - Under Section 7,2014,0,0,0,0,0,0,0,0,0,0,0,0,0,0,0
Chhattisgarh,7.4 - Under Section 8,2014,0,0,0,0,0,0,0,0,0,0,0,0,0,0,0
Chhattisgarh,7.5 - Other Sections under ITP Act,2014,4,3,7,3,2,5,0,0,0,0,0,0,7,5,12
Chhattisgarh,"8 - Indian Railways Act, 1989",2014,6,0,6,2,0,2,0,0,0,0,0,0,8,0,8
Chhattisgarh,"9 - Registration of Foreigners Act, 1939",2014,0,0,0,0,0,0,0,0,0,0,0,0,0,0,0
Chhattisgarh,"10 - Protection of Civil Rights Act, 1955",2014,0,0,0,0,0,0,0,0,0,0,0,0,0,0,0
Chhattisgarh,10.1 - PCR Act for crimes committed against SCs,2014,0,0,0,0,0,0,0,0,0,0,0,0,0,0,0
Chhattisgarh,10.2 - PCR Act for crimes committed against STs,2014,0,0,0,0,0,0,0,0,0,0,0,0,0,0,0
Chhattisgarh,10.3 - PCR Act for crimes committed against Others,2014,0,0,0,0,0,0,0,0,0,0,0,0,0,0,0
Chhattisgarh,"11 - Passport Act, 1967",2014,0,0,0,0,0,0,0,0,0,0,0,0,0,0,0
Chhattisgarh,"12 - Essential Commodities Act, 1955",2014,30,2,32,35,1,36,2,0,2,1,0,1,68,3,71
Chhattisgarh,"13 - Antiquities & Art Treasures Act, 1972",2014,0,0,0,0,0,0,0,0,0,0,0,0,0,0,0
Chhattisgarh,"14 - Dowry Prohibition Act, 1961",2014,10,2,12,8,3,11,1,0,1,0,0,0,19,5,24
Chhattisgarh,"15 - Indecent Representation of Women (Prohibition) Act, 1986",2014,0,0,0,0,0,0,0,0,0,0,0,0,0,0,0
Chhattisgarh,"16 - Copyright Act, 1957",2014,1,0,1,3,0,3,0,0,0,0,0,0,4,0,4
Chhattisgarh,17 - Commission of Sati Prevention Act 1987,2014,0,0,0,0,0,0,0,0,0,0,0,0,0,0,0
Chhattisgarh,"18 - SC/ST (Prevention of Atrocities) Act, 1989)",2014,185,9,194,133,33,166,46,3,49,10,1,11,374,46,420
Chhattisgarh,18.1 - POA Act for crimes committed against SCs,2014,77,3,80,48,3,51,18,1,19,4,1,5,147,8,155
Chhattisgarh,18.2 - POA Act for crimes committed against STs,2014,108,6,114,85,30,115,28,2,30,6,0,6,227,38,265
Chhattisgarh,"19 - Forest Act, 1927",2014,0,0,0,1,0,1,0,0,0,0,0,0,1,0,1
Chhattisgarh,"20 - Prohibition of Child Marriage Act, 2006",2014,1,0,1,2,0,2,1,0,1,0,0,0,4,0,4
Chhattisgarh,"21 - Protection of Women from Domestic Violence Act, 2005",2014,0,0,0,0,0,0,0,0,0,0,0,0,0,0,0
Chhattisgarh,"22 - Information Technology Act, 2000",2014,50,2,52,22,0,22,4,0,4,0,0,0,76,2,78
Chhattisgarh,"23 - Official Secrets Act, 1923",2014,0,0,0,0,0,0,0,0,0,0,0,0,0,0,0
Chhattisgarh,"24 - Electricity Act, 2003",2014,29,0,29,32,0,32,9,0,9,3,0,3,73,0,73
Chhattisgarh,"25 - Wildlife Protection Act, 1972",2014,8,0,8,16,0,16,3,0,3,0,0,0,27,0,27
Chhattisgarh,"26 - Bonded Labour System (Abolition) Act, 1976",2014,0,0,0,0,0,0,0,0,0,0,0,0,0,0,0
Chhattisgarh,26.1 - Against SCs,2014,0,0,0,0,0,0,0,0,0,0,0,0,0,0,0
Chhattisgarh,26.2 - Against STs,2014,0,0,0,0,0,0,0,0,0,0,0,0,0,0,0
Chhattisgarh,26.3 - Against others,2014,0,0,0,0,0,0,0,0,0,0,0,0,0,0,0
Chhattisgarh,"27 - Environmental (Protection) Act, 1986",2014,0,0,0,0,0,0,0,0,0,0,0,0,0,0,0
Chhattisgarh,"28 - Air (Prevention & Control of Pollution) Act, 1981",2014,0,0,0,0,0,0,0,0,0,0,0,0,0,0,0
Chhattisgarh,"29 - Water (Prevention & Control of Pollution) Act, 1974(as amended in 1988)",2014,0,0,0,0,0,0,0,0,0,0,0,0,0,0,0
Chhattisgarh,"30 - National Security Act, 1980",2014,0,0,0,0,0,0,0,0,0,0,0,0,0,0,0
Chhattisgarh,"31 - Unlawful Activities (Prevention) Act, 1967",2014,4,0,4,9,0,9,3,0,3,1,0,1,17,0,17
Chhattisgarh,"32 - Young Persons (Harmful Publications) Act, 1956",2014,0,0,0,0,0,0,0,0,0,0,0,0,0,0,0
Chhattisgarh,"33 - Railway Property (Unlawful Possession) Act, 1966",2014,0,0,0,0,0,0,0,0,0,0,0,0,0,0,0
Chhattisgarh,"34 - Prevention of Damage to Public Property Act, 1984",2014,0,0,0,2,0,2,0,0,0,0,0,0,2,0,2
Chhattisgarh,"35 - Transplantation of Human Organs Act, 1994",2014,0,0,0,0,0,0,0,0,0,0,0,0,0,0,0
Chhattisgarh,"36 - Trade Marks Act, 1999",2014,0,0,0,0,0,0,0,0,0,0,0,0,0,0,0
Chhattisgarh,"37 - Prevention of Insults to National Honour Act, 1971",2014,0,0,0,1,0,1,0,0,0,0,0,0,1,0,1
Chhattisgarh,"38 - State Emblem (Prohibition of Improper Use) Act, 2005",2014,0,0,0,0,0,0,0,0,0,0,0,0,0,0,0
Chhattisgarh,"39 - Lotteries (Regulation) Act, 1998",2014,0,0,0,0,0,0,0,0,0,0,0,0,0,0,0
Chhattisgarh,"40 - Citizenship Act, 1955",2014,0,0,0,0,0,0,0,0,0,0,0,0,0,0,0
Chhattisgarh,"41 - Foreigners Act, 1946",2014,0,0,0,0,0,0,0,0,0,0,0,0,0,0,0
Chhattisgarh,"42 - Place of Worship (Special Provisions) Act, 1991",2014,0,0,0,0,0,0,0,0,0,0,0,0,0,0,0
Chhattisgarh,"43 - Religious Institution (Prevention of Misuse) Act, 1988",2014,0,0,0,0,0,0,0,0,0,0,0,0,0,0,0
Chhattisgarh,"44 - Representation of People Act, 1951",2014,0,0,0,0,0,0,0,0,0,0,0,0,0,0,0
Chhattisgarh,"45 - Emigration Act, 1983",2014,0,0,0,0,0,0,0,0,0,0,0,0,0,0,0
Chhattisgarh,"46 - Juvenile Justice (Care and Protection of Children) Act, 2000",2014,0,0,0,0,0,0,0,0,0,0,0,0,0,0,0
Chhattisgarh,"47 - Infant Substitutes Regulation Act, 2003",2014,0,0,0,0,0,0,0,0,0,0,0,0,0,0,0
Chhattisgarh,"48 - Anti-Hijacking Act, 1982",2014,0,0,0,0,0,0,0,0,0,0,0,0,0,0,0
Chhattisgarh,"49 - Atomic Energy Act, 1962",2014,0,0,0,0,0,0,0,0,0,0,0,0,0,0,0
Chhattisgarh,"50 - Weapons of Mass Destruction (Proh. of Unlawful Activities) Act, 2005",2014,0,0,0,0,0,0,0,0,0,0,0,0,0,0,0
Chhattisgarh,"51 - Suppression of Unlawful Acts against Safety of Civil Aviation Act, 1982",2014,0,0,0,0,0,0,0,0,0,0,0,0,0,0,0
Chhattisgarh,"52 - Safety of Maritime Navigation Act, 2002",2014,0,0,0,0,0,0,0,0,0,0,0,0,0,0,0
Chhattisgarh,"53 - Manual Scavengers and Construction of Dry Latrines (P) Act, 1993",2014,0,0,0,0,0,0,0,0,0,0,0,0,0,0,0
Chhattisgarh,"54 - Pre-Natal Diagnostic Techniques (Reg and Prev of Misuse) Act, 1994",2014,0,0,0,0,0,0,0,0,0,0,0,0,0,0,0
Chhattisgarh,"55 - The Maritime Zones of India (Reg of Fishing by Foreign Vessels) Act, 1981",2014,0,0,0,0,0,0,0,0,0,0,0,0,0,0,0
Chhattisgarh,56 - Other SLL crimes,2014,159457,129,159586,63507,62,63569,20834,18,20852,2363,1,2364,246161,210,246371
Chhattisgarh,57 - Total Cognizable SLL crimes,2014,178931,353,179284,81013,443,81456,26947,143,27090,2940,11,2951,289831,950,290781
Goa,"1 - Arms Act, 1959",2014,0,0,0,0,0,0,0,0,0,0,0,0,0,0,0
Goa,"2 - Narcotic Drugs & Psychotropic Substances Act, 1985",2014,29,0,29,18,0,18,10,2,12,1,0,1,58,2,60
Goa,"3 - Gambling Act, 1867",2014,236,0,236,348,0,348,124,0,124,20,0,20,728,0,728
Goa,"4 - Excise Act, 1944",2014,0,0,0,0,0,0,0,0,0,0,0,0,0,0,0
Goa,5 - Prohibition Act,2014,0,0,0,0,0,0,0,0,0,0,0,0,0,0,0
Goa,6 - Explosives and Explosive Substances Act,2014,0,0,0,0,0,0,1,0,1,0,0,0,1,0,1
Goa,"7 - Immoral Traffic (Prevention) Act, 1956",2014,6,2,8,11,1,12,0,0,0,0,0,0,17,3,20
Goa,7.1 - Under Section 5,2014,4,1,5,8,0,8,0,0,0,0,0,0,12,1,13
Goa,7.2 - Under Section 6,2014,0,0,0,0,0,0,0,0,0,0,0,0,0,0,0
Goa,7.3 - Under Section 7,2014,0,0,0,0,0,0,0,0,0,0,0,0,0,0,0
Goa,7.4 - Under Section 8,2014,0,0,0,0,0,0,0,0,0,0,0,0,0,0,0
Goa,7.5 - Other Sections under ITP Act,2014,2,1,3,3,1,4,0,0,0,0,0,0,5,2,7
Goa,"8 - Indian Railways Act, 1989",2014,2,0,2,1,0,1,0,0,0,0,0,0,3,0,3
Goa,"9 - Registration of Foreigners Act, 1939",2014,0,0,0,0,0,0,0,0,0,0,0,0,0,0,0
Goa,"10 - Protection of Civil Rights Act, 1955",2014,0,0,0,0,0,0,0,0,0,0,0,0,0,0,0
Goa,10.1 - PCR Act for crimes committed against SCs,2014,0,0,0,0,0,0,0,0,0,0,0,0,0,0,0
Goa,10.2 - PCR Act for crimes committed against STs,2014,0,0,0,0,0,0,0,0,0,0,0,0,0,0,0
Goa,10.3 - PCR Act for crimes committed against Others,2014,0,0,0,0,0,0,0,0,0,0,0,0,0,0,0
Goa,"11 - Passport Act, 1967",2014,0,0,0,0,0,0,0,0,0,0,0,0,0,0,0
Goa,"12 - Essential Commodities Act, 1955",2014,0,0,0,1,1,2,2,1,3,0,0,0,3,2,5
Goa,"13 - Antiquities & Art Treasures Act, 1972",2014,0,0,0,0,0,0,0,0,0,0,0,0,0,0,0
Goa,"14 - Dowry Prohibition Act, 1961",2014,0,0,0,0,0,0,0,0,0,0,0,0,0,0,0
Goa,"15 - Indecent Representation of Women (Prohibition) Act, 1986",2014,0,0,0,0,0,0,0,0,0,0,0,0,0,0,0
Goa,"16 - Copyright Act, 1957",2014,3,0,3,1,0,1,0,0,0,0,0,0,4,0,4
Goa,17 - Commission of Sati Prevention Act 1987,2014,0,0,0,0,0,0,0,0,0,0,0,0,0,0,0
Goa,"18 - SC/ST (Prevention of Atrocities) Act, 1989)",2014,3,0,3,4,0,4,3,1,4,2,2,4,12,3,15
Goa,18.1 - POA Act for crimes committed against SCs,2014,3,0,3,3,0,3,2,1,3,1,0,1,9,1,10
Goa,18.2 - POA Act for crimes committed against STs,2014,0,0,0,1,0,1,1,0,1,1,2,3,3,2,5
Goa,"19 - Forest Act, 1927",2014,0,0,0,0,0,0,0,0,0,0,0,0,0,0,0
Goa,"20 - Prohibition of Child Marriage Act, 2006",2014,0,0,0,0,0,0,0,0,0,0,0,0,0,0,0
Goa,"21 - Protection of Women from Domestic Violence Act, 2005",2014,1,0,1,0,0,0,0,0,0,0,0,0,1,0,1
Goa,"22 - Information Technology Act, 2000",2014,0,1,1,1,0,1,1,0,1,0,0,0,2,1,3
Goa,"23 - Official Secrets Act, 1923",2014,0,0,0,0,0,0,0,0,0,0,0,0,0,0,0
Goa,"24 - Electricity Act, 2003",2014,0,0,0,0,0,0,0,0,0,0,0,0,0,0,0
Goa,"25 - Wildlife Protection Act, 1972",2014,0,0,0,0,0,0,0,0,0,0,0,0,0,0,0
Goa,"26 - Bonded Labour System (Abolition) Act, 1976",2014,0,0,0,0,0,0,0,0,0,0,0,0,0,0,0
Goa,26.1 - Against SCs,2014,0,0,0,0,0,0,0,0,0,0,0,0,0,0,0
Goa,26.2 - Against STs,2014,0,0,0,0,0,0,0,0,0,0,0,0,0,0,0
Goa,26.3 - Against others,2014,0,0,0,0,0,0,0,0,0,0,0,0,0,0,0
Goa,"27 - Environmental (Protection) Act, 1986",2014,2,0,2,1,0,1,0,0,0,0,0,0,3,0,3
Goa,"28 - Air (Prevention & Control of Pollution) Act, 1981",2014,0,0,0,0,0,0,0,0,0,0,0,0,0,0,0
Goa,"29 - Water (Prevention & Control of Pollution) Act, 1974(as amended in 1988)",2014,0,0,0,0,0,0,0,0,0,0,0,0,0,0,0
Goa,"30 - National Security Act, 1980",2014,0,0,0,0,0,0,0,0,0,0,0,0,0,0,0
Goa,"31 - Unlawful Activities (Prevention) Act, 1967",2014,0,0,0,0,0,0,0,0,0,0,0,0,0,0,0
Goa,"32 - Young Persons (Harmful Publications) Act, 1956",2014,0,0,0,0,0,0,0,0,0,0,0,0,0,0,0
Goa,"33 - Railway Property (Unlawful Possession) Act, 1966",2014,0,0,0,0,0,0,0,0,0,0,0,0,0,0,0
Goa,"34 - Prevention of Damage to Public Property Act, 1984",2014,5,0,5,10,0,10,1,0,1,0,0,0,16,0,16
Goa,"35 - Transplantation of Human Organs Act, 1994",2014,0,0,0,0,0,0,0,0,0,0,0,0,0,0,0
Goa,"36 - Trade Marks Act, 1999",2014,0,0,0,0,0,0,0,0,0,0,0,0,0,0,0
Goa,"37 - Prevention of Insults to National Honour Act, 1971",2014,0,0,0,0,0,0,0,0,0,0,0,0,0,0,0
Goa,"38 - State Emblem (Prohibition of Improper Use) Act, 2005",2014,0,0,0,0,0,0,0,0,0,0,0,0,0,0,0
Goa,"39 - Lotteries (Regulation) Act, 1998",2014,0,0,0,0,0,0,0,0,0,0,0,0,0,0,0
Goa,"40 - Citizenship Act, 1955",2014,0,0,0,0,0,0,0,0,0,0,0,0,0,0,0
Goa,"41 - Foreigners Act, 1946",2014,3,1,4,9,2,11,1,1,2,0,0,0,13,4,17
Goa,"42 - Place of Worship (Special Provisions) Act, 1991",2014,0,0,0,0,0,0,0,0,0,0,0,0,0,0,0
Goa,"43 - Religious Institution (Prevention of Misuse) Act, 1988",2014,0,0,0,0,0,0,0,0,0,0,0,0,0,0,0
Goa,"44 - Representation of People Act, 1951",2014,0,0,0,0,0,0,0,0,0,0,0,0,0,0,0
Goa,"45 - Emigration Act, 1983",2014,0,0,0,0,1,1,0,0,0,0,0,0,0,1,1
Goa,"46 - Juvenile Justice (Care and Protection of Children) Act, 2000",2014,0,0,0,2,0,2,0,0,0,0,0,0,2,0,2
Goa,"47 - Infant Substitutes Regulation Act, 2003",2014,0,0,0,0,0,0,0,0,0,0,0,0,0,0,0
Goa,"48 - Anti-Hijacking Act, 1982",2014,0,0,0,0,0,0,0,0,0,0,0,0,0,0,0
Goa,"49 - Atomic Energy Act, 1962",2014,0,0,0,0,0,0,0,0,0,0,0,0,0,0,0
Goa,"50 - Weapons of Mass Destruction (Proh. of Unlawful Activities) Act, 2005",2014,0,0,0,0,0,0,0,0,0,0,0,0,0,0,0
Goa,"51 - Suppression of Unlawful Acts against Safety of Civil Aviation Act, 1982",2014,0,0,0,0,0,0,0,0,0,0,0,0,0,0,0
Goa,"52 - Safety of Maritime Navigation Act, 2002",2014,0,0,0,0,0,0,0,0,0,0,0,0,0,0,0
Goa,"53 - Manual Scavengers and Construction of Dry Latrines (P) Act, 1993",2014,0,0,0,0,0,0,0,0,0,0,0,0,0,0,0
Goa,"54 - Pre-Natal Diagnostic Techniques (Reg and Prev of Misuse) Act, 1994",2014,0,0,0,0,0,0,0,0,0,0,0,0,0,0,0
Goa,"55 - The Maritime Zones of India (Reg of Fishing by Foreign Vessels) Act, 1981",2014,0,0,0,0,0,0,0,0,0,0,0,0,0,0,0
Goa,56 - Other SLL crimes,2014,1143,62,1205,702,36,738,375,15,390,49,2,51,2269,115,2384
Goa,57 - Total Cognizable SLL crimes,2014,1433,66,1499,1109,41,1150,518,20,538,72,4,76,3132,131,3263
Gujarat,"1 - Arms Act, 1959",2014,302,1,303,416,1,417,91,0,91,8,0,8,817,2,819
Gujarat,"2 - Narcotic Drugs & Psychotropic Substances Act, 1985",2014,17,0,17,38,3,41,12,0,12,0,0,0,67,3,70
Gujarat,"3 - Gambling Act, 1867",2014,15003,145,15148,16988,388,17376,7880,168,8048,655,9,664,40526,710,41236
Gujarat,"4 - Excise Act, 1944",2014,0,0,0,0,0,0,0,0,0,0,0,0,0,0,0
Gujarat,5 - Prohibition Act,2014,54456,20902,75358,74558,42378,116936,31054,25589,56643,1690,1100,2790,161758,89969,251727
Gujarat,6 - Explosives and Explosive Substances Act,2014,16,0,16,38,0,38,7,0,7,0,0,0,61,0,61
Gujarat,"7 - Immoral Traffic (Prevention) Act, 1956",2014,49,3,52,54,13,67,15,3,18,1,0,1,119,19,138
Gujarat,7.1 - Under Section 5,2014,21,2,23,27,5,32,2,2,4,1,0,1,51,9,60
Gujarat,7.2 - Under Section 6,2014,8,1,9,8,1,9,4,1,5,0,0,0,20,3,23
Gujarat,7.3 - Under Section 7,2014,0,0,0,2,2,4,2,0,2,0,0,0,4,2,6
Gujarat,7.4 - Under Section 8,2014,2,0,2,2,1,3,2,0,2,0,0,0,6,1,7
Gujarat,7.5 - Other Sections under ITP Act,2014,18,0,18,15,4,19,5,0,5,0,0,0,38,4,42
Gujarat,"8 - Indian Railways Act, 1989",2014,0,0,0,0,0,0,0,0,0,0,0,0,0,0,0
Gujarat,"9 - Registration of Foreigners Act, 1939",2014,0,0,0,0,0,0,0,0,0,0,0,0,0,0,0
Gujarat,"10 - Protection of Civil Rights Act, 1955",2014,9,0,9,12,0,12,11,0,11,0,0,0,32,0,32
Gujarat,10.1 - PCR Act for crimes committed against SCs,2014,9,0,9,12,0,12,11,0,11,0,0,0,32,0,32
Gujarat,10.2 - PCR Act for crimes committed against STs,2014,0,0,0,0,0,0,0,0,0,0,0,0,0,0,0
Gujarat,10.3 - PCR Act for crimes committed against Others,2014,0,0,0,0,0,0,0,0,0,0,0,0,0,0,0
Gujarat,"11 - Passport Act, 1967",2014,2,0,2,8,3,11,1,0,1,0,0,0,11,3,14
Gujarat,"12 - Essential Commodities Act, 1955",2014,24,0,24,64,3,67,15,1,16,1,0,1,104,4,108
Gujarat,"13 - Antiquities & Art Treasures Act, 1972",2014,0,0,0,1,0,1,0,0,0,0,0,0,1,0,1
Gujarat,"14 - Dowry Prohibition Act, 1961",2014,53,8,61,31,12,43,20,48,68,0,1,1,104,69,173
Gujarat,"15 - Indecent Representation of Women (Prohibition) Act, 1986",2014,0,0,0,0,0,0,0,0,0,0,0,0,0,0,0
Gujarat,"16 - Copyright Act, 1957",2014,126,0,126,149,0,149,34,0,34,1,0,1,310,0,310
Gujarat,17 - Commission of Sati Prevention Act 1987,2014,0,0,0,0,0,0,0,0,0,0,0,0,0,0,0
Gujarat,"18 - SC/ST (Prevention of Atrocities) Act, 1989)",2014,233,15,248,241,17,258,45,8,53,2,2,4,521,42,563
Gujarat,18.1 - POA Act for crimes committed against SCs,2014,209,12,221,213,14,227,36,8,44,2,2,4,460,36,496
Gujarat,18.2 - POA Act for crimes committed against STs,2014,24,3,27,28,3,31,9,0,9,0,0,0,61,6,67
Gujarat,"19 - Forest Act, 1927",2014,0,0,0,1,0,1,0,0,0,0,0,0,1,0,1
Gujarat,"20 - Prohibition of Child Marriage Act, 2006",2014,10,4,14,26,13,39,14,8,22,0,0,0,50,25,75
Gujarat,"21 - Protection of Women from Domestic Violence Act, 2005",2014,0,0,0,2,0,2,0,0,0,0,0,0,2,0,2
Gujarat,"22 - Information Technology Act, 2000",2014,55,1,56,32,2,34,5,0,5,0,0,0,92,3,95
Gujarat,"23 - Official Secrets Act, 1923",2014,2,0,2,2,0,2,0,0,0,0,0,0,4,0,4
Gujarat,"24 - Electricity Act, 2003",2014,9,0,9,16,0,16,1,0,1,0,0,0,26,0,26
Gujarat,"25 - Wildlife Protection Act, 1972",2014,7,0,7,22,0,22,18,0,18,0,0,0,47,0,47
Gujarat,"26 - Bonded Labour System (Abolition) Act, 1976",2014,0,0,0,0,0,0,0,0,0,0,0,0,0,0,0
Gujarat,26.1 - Against SCs,2014,0,0,0,0,0,0,0,0,0,0,0,0,0,0,0
Gujarat,26.2 - Against STs,2014,0,0,0,0,0,0,0,0,0,0,0,0,0,0,0
Gujarat,26.3 - Against others,2014,0,0,0,0,0,0,0,0,0,0,0,0,0,0,0
Gujarat,"27 - Environmental (Protection) Act, 1986",2014,0,0,0,4,0,4,2,0,2,0,0,0,6,0,6
Gujarat,"28 - Air (Prevention & Control of Pollution) Act, 1981",2014,0,0,0,0,0,0,0,0,0,0,0,0,0,0,0
Gujarat,"29 - Water (Prevention & Control of Pollution) Act, 1974(as amended in 1988)",2014,0,0,0,0,0,0,0,0,0,0,0,0,0,0,0
Gujarat,"30 - National Security Act, 1980",2014,0,0,0,0,0,0,0,0,0,0,0,0,0,0,0
Gujarat,"31 - Unlawful Activities (Prevention) Act, 1967",2014,0,0,0,0,0,0,0,0,0,0,0,0,0,0,0
Gujarat,"32 - Young Persons (Harmful Publications) Act, 1956",2014,0,0,0,0,0,0,0,0,0,0,0,0,0,0,0
Gujarat,"33 - Railway Property (Unlawful Possession) Act, 1966",2014,0,0,0,0,0,0,0,0,0,0,0,0,0,0,0
Gujarat,"34 - Prevention of Damage to Public Property Act, 1984",2014,26,0,26,20,0,20,2,0,2,1,0,1,49,0,49
Gujarat,"35 - Transplantation of Human Organs Act, 1994",2014,0,0,0,0,0,0,0,0,0,0,0,0,0,0,0
Gujarat,"36 - Trade Marks Act, 1999",2014,2,0,2,1,0,1,0,0,0,0,0,0,3,0,3
Gujarat,"37 - Prevention of Insults to National Honour Act, 1971",2014,0,0,0,0,0,0,0,0,0,0,0,0,0,0,0
Gujarat,"38 - State Emblem (Prohibition of Improper Use) Act, 2005",2014,0,0,0,0,0,0,0,0,0,0,0,0,0,0,0
Gujarat,"39 - Lotteries (Regulation) Act, 1998",2014,3,0,3,3,0,3,1,0,1,0,0,0,7,0,7
Gujarat,"40 - Citizenship Act, 1955",2014,0,0,0,0,0,0,0,0,0,0,0,0,0,0,0
Gujarat,"41 - Foreigners Act, 1946",2014,3,0,3,4,2,6,0,0,0,0,0,0,7,2,9
Gujarat,"42 - Place of Worship (Special Provisions) Act, 1991",2014,0,0,0,0,0,0,0,0,0,0,0,0,0,0,0
Gujarat,"43 - Religious Institution (Prevention of Misuse) Act, 1988",2014,0,0,0,0,0,0,0,0,0,0,0,0,0,0,0
Gujarat,"44 - Representation of People Act, 1951",2014,1,0,1,1,0,1,4,0,4,0,0,0,6,0,6
Gujarat,"45 - Emigration Act, 1983",2014,0,0,0,0,0,0,0,0,0,0,0,0,0,0,0
Gujarat,"46 - Juvenile Justice (Care and Protection of Children) Act, 2000",2014,26,1,27,39,1,40,14,2,16,2,0,2,81,4,85
Gujarat,"47 - Infant Substitutes Regulation Act, 2003",2014,0,0,0,0,0,0,0,0,0,0,0,0,0,0,0
Gujarat,"48 - Anti-Hijacking Act, 1982",2014,0,0,0,0,0,0,0,0,0,0,0,0,0,0,0
Gujarat,"49 - Atomic Energy Act, 1962",2014,0,0,0,0,0,0,0,0,0,0,0,0,0,0,0
Gujarat,"50 - Weapons of Mass Destruction (Proh. of Unlawful Activities) Act, 2005",2014,0,0,0,0,0,0,0,0,0,0,0,0,0,0,0
Gujarat,"51 - Suppression of Unlawful Acts against Safety of Civil Aviation Act, 1982",2014,0,0,0,0,0,0,0,0,0,0,0,0,0,0,0
Gujarat,"52 - Safety of Maritime Navigation Act, 2002",2014,0,0,0,0,0,0,0,0,0,0,0,0,0,0,0
Gujarat,"53 - Manual Scavengers and Construction of Dry Latrines (P) Act, 1993",2014,0,0,0,0,0,0,0,0,0,0,0,0,0,0,0
Gujarat,"54 - Pre-Natal Diagnostic Techniques (Reg and Prev of Misuse) Act, 1994",2014,0,0,0,0,1,1,0,0,0,0,0,0,0,1,1
Gujarat,"55 - The Maritime Zones of India (Reg of Fishing by Foreign Vessels) Act, 1981",2014,0,0,0,0,0,0,0,0,0,0,0,0,0,0,0
Gujarat,56 - Other SLL crimes,2014,18187,441,18628,19949,857,20806,7742,383,8125,547,20,567,46425,1701,48126
Gujarat,57 - Total Cognizable SLL crimes,2014,88621,21521,110142,112720,43694,156414,46988,26210,73198,2908,1132,4040,251237,92557,343794
Haryana,"1 - Arms Act, 1959",2014,1091,0,1091,576,1,577,37,0,37,1,0,1,1705,1,1706
Haryana,"2 - Narcotic Drugs & Psychotropic Substances Act, 1985",2014,548,11,559,519,25,544,160,5,165,34,0,34,1261,41,1302
Haryana,"3 - Gambling Act, 1867",2014,2844,0,2844,3338,1,3339,878,0,878,58,0,58,7118,1,7119
Haryana,"4 - Excise Act, 1944",2014,6797,1,6798,6781,0,6781,1927,1,1928,97,0,97,15602,2,15604
Haryana,5 - Prohibition Act,2014,0,0,0,0,0,0,0,0,0,0,0,0,0,0,0
Haryana,6 - Explosives and Explosive Substances Act,2014,8,0,8,10,0,10,2,0,2,0,0,0,20,0,20
Haryana,"7 - Immoral Traffic (Prevention) Act, 1956",2014,110,122,232,63,44,107,8,2,10,0,0,0,181,168,349
Haryana,7.1 - Under Section 5,2014,55,38,93,17,17,34,1,0,1,0,0,0,73,55,128
Haryana,7.2 - Under Section 6,2014,13,31,44,14,2,16,0,0,0,0,0,0,27,33,60
Haryana,7.3 - Under Section 7,2014,4,5,9,4,0,4,0,0,0,0,0,0,8,5,13
Haryana,7.4 - Under Section 8,2014,0,0,0,0,0,0,0,0,0,0,0,0,0,0,0
Haryana,7.5 - Other Sections under ITP Act,2014,38,48,86,28,25,53,7,2,9,0,0,0,73,75,148
Haryana,"8 - Indian Railways Act, 1989",2014,0,0,0,0,0,0,0,0,0,0,0,0,0,0,0
Haryana,"9 - Registration of Foreigners Act, 1939",2014,0,0,0,3,0,3,0,0,0,0,0,0,3,0,3
Haryana,"10 - Protection of Civil Rights Act, 1955",2014,39,1,40,18,0,18,0,0,0,0,0,0,57,1,58
Haryana,10.1 - PCR Act for crimes committed against SCs,2014,39,1,40,18,0,18,0,0,0,0,0,0,57,1,58
Haryana,10.2 - PCR Act for crimes committed against STs,2014,0,0,0,0,0,0,0,0,0,0,0,0,0,0,0
Haryana,10.3 - PCR Act for crimes committed against Others,2014,0,0,0,0,0,0,0,0,0,0,0,0,0,0,0
Haryana,"11 - Passport Act, 1967",2014,1,0,1,0,0,0,0,0,0,0,0,0,1,0,1
Haryana,"12 - Essential Commodities Act, 1955",2014,61,0,61,86,1,87,23,0,23,0,0,0,170,1,171
Haryana,"13 - Antiquities & Art Treasures Act, 1972",2014,0,0,0,0,0,0,0,0,0,0,0,0,0,0,0
Haryana,"14 - Dowry Prohibition Act, 1961",2014,3,1,4,4,0,4,2,1,3,0,0,0,9,2,11
Haryana,"15 - Indecent Representation of Women (Prohibition) Act, 1986",2014,0,0,0,0,0,0,0,0,0,0,0,0,0,0,0
Haryana,"16 - Copyright Act, 1957",2014,54,0,54,56,0,56,4,0,4,0,0,0,114,0,114
Haryana,17 - Commission of Sati Prevention Act 1987,2014,0,0,0,0,0,0,0,0,0,0,0,0,0,0,0
Haryana,"18 - SC/ST (Prevention of Atrocities) Act, 1989)",2014,3,0,3,0,0,0,0,0,0,0,0,0,3,0,3
Haryana,18.1 - POA Act for crimes committed against SCs,2014,3,0,3,0,0,0,0,0,0,0,0,0,3,0,3
Haryana,18.2 - POA Act for crimes committed against STs,2014,0,0,0,0,0,0,0,0,0,0,0,0,0,0,0
Haryana,"19 - Forest Act, 1927",2014,4,0,4,7,0,7,0,0,0,0,0,0,11,0,11
Haryana,"20 - Prohibition of Child Marriage Act, 2006",2014,10,0,10,4,1,5,1,0,1,0,0,0,15,1,16
Haryana,"21 - Protection of Women from Domestic Violence Act, 2005",2014,3,0,3,0,0,0,0,0,0,0,0,0,3,0,3
Haryana,"22 - Information Technology Act, 2000",2014,35,2,37,51,2,53,11,0,11,1,0,1,98,4,102
Haryana,"23 - Official Secrets Act, 1923",2014,0,0,0,0,0,0,0,0,0,0,0,0,0,0,0
Haryana,"24 - Electricity Act, 2003",2014,581,0,581,450,7,457,96,1,97,15,0,15,1142,8,1150
Haryana,"25 - Wildlife Protection Act, 1972",2014,7,0,7,10,0,10,0,0,0,0,0,0,17,0,17
Haryana,"26 - Bonded Labour System (Abolition) Act, 1976",2014,0,0,0,1,0,1,0,0,0,0,0,0,1,0,1
Haryana,26.1 - Against SCs,2014,0,0,0,0,0,0,0,0,0,0,0,0,0,0,0
Haryana,26.2 - Against STs,2014,0,0,0,0,0,0,0,0,0,0,0,0,0,0,0
Haryana,26.3 - Against others,2014,0,0,0,1,0,1,0,0,0,0,0,0,1,0,1
Haryana,"27 - Environmental (Protection) Act, 1986",2014,0,0,0,0,0,0,0,0,0,0,0,0,0,0,0
Haryana,"28 - Air (Prevention & Control of Pollution) Act, 1981",2014,0,0,0,0,0,0,0,0,0,0,0,0,0,0,0
Haryana,"29 - Water (Prevention & Control of Pollution) Act, 1974(as amended in 1988)",2014,0,0,0,0,0,0,0,0,0,0,0,0,0,0,0
Haryana,"30 - National Security Act, 1980",2014,0,0,0,0,0,0,0,0,0,0,0,0,0,0,0
Haryana,"31 - Unlawful Activities (Prevention) Act, 1967",2014,562,4,566,329,1,330,37,0,37,7,0,7,935,5,940
Haryana,"32 - Young Persons (Harmful Publications) Act, 1956",2014,0,0,0,0,0,0,0,0,0,0,0,0,0,0,0
Haryana,"33 - Railway Property (Unlawful Possession) Act, 1966",2014,0,0,0,0,0,0,0,0,0,0,0,0,0,0,0
Haryana,"34 - Prevention of Damage to Public Property Act, 1984",2014,816,0,816,490,0,490,209,0,209,1,0,1,1516,0,1516
Haryana,"35 - Transplantation of Human Organs Act, 1994",2014,0,0,0,0,0,0,0,0,0,0,0,0,0,0,0
Haryana,"36 - Trade Marks Act, 1999",2014,0,0,0,1,0,1,0,0,0,0,0,0,1,0,1
Haryana,"37 - Prevention of Insults to National Honour Act, 1971",2014,0,0,0,2,0,2,0,0,0,0,0,0,2,0,2
Haryana,"38 - State Emblem (Prohibition of Improper Use) Act, 2005",2014,0,0,0,0,0,0,0,0,0,0,0,0,0,0,0
Haryana,"39 - Lotteries (Regulation) Act, 1998",2014,0,0,0,0,0,0,0,0,0,0,0,0,0,0,0
Haryana,"40 - Citizenship Act, 1955",2014,0,0,0,0,0,0,0,0,0,0,0,0,0,0,0
Haryana,"41 - Foreigners Act, 1946",2014,12,0,12,7,0,7,0,0,0,0,0,0,19,0,19
Haryana,"42 - Place of Worship (Special Provisions) Act, 1991",2014,0,0,0,0,0,0,0,0,0,0,0,0,0,0,0
Haryana,"43 - Religious Institution (Prevention of Misuse) Act, 1988",2014,0,0,0,0,0,0,0,0,0,0,0,0,0,0,0
Haryana,"44 - Representation of People Act, 1951",2014,34,0,34,27,0,27,9,0,9,0,0,0,70,0,70
Haryana,"45 - Emigration Act, 1983",2014,0,0,0,0,0,0,0,0,0,0,0,0,0,0,0
Haryana,"46 - Juvenile Justice (Care and Protection of Children) Act, 2000",2014,8,2,10,34,1,35,6,0,6,0,0,0,48,3,51
Haryana,"47 - Infant Substitutes Regulation Act, 2003",2014,0,0,0,0,0,0,0,0,0,0,0,0,0,0,0
Haryana,"48 - Anti-Hijacking Act, 1982",2014,0,0,0,0,0,0,0,0,0,0,0,0,0,0,0
Haryana,"49 - Atomic Energy Act, 1962",2014,0,0,0,0,0,0,0,0,0,0,0,0,0,0,0
Haryana,"50 - Weapons of Mass Destruction (Proh. of Unlawful Activities) Act, 2005",2014,0,0,0,0,0,0,0,0,0,0,0,0,0,0,0
Haryana,"51 - Suppression of Unlawful Acts against Safety of Civil Aviation Act, 1982",2014,0,0,0,0,0,0,0,0,0,0,0,0,0,0,0
Haryana,"52 - Safety of Maritime Navigation Act, 2002",2014,0,0,0,0,0,0,0,0,0,0,0,0,0,0,0
Haryana,"53 - Manual Scavengers and Construction of Dry Latrines (P) Act, 1993",2014,0,0,0,0,0,0,0,0,0,0,0,0,0,0,0
Haryana,"54 - Pre-Natal Diagnostic Techniques (Reg and Prev of Misuse) Act, 1994",2014,6,0,6,19,2,21,2,1,3,1,1,2,28,4,32
Haryana,"55 - The Maritime Zones of India (Reg of Fishing by Foreign Vessels) Act, 1981",2014,0,0,0,0,0,0,0,0,0,0,0,0,0,0,0
Haryana,56 - Other SLL crimes,2014,2065,10,2075,1937,6,1943,553,2,555,19,1,20,4574,19,4593
Haryana,57 - Total Cognizable SLL crimes,2014,15702,154,15856,14823,92,14915,3965,13,3978,234,2,236,34724,261,34985
Himachal Pradesh,"1 - Arms Act, 1959",2014,5,0,5,17,0,17,9,0,9,1,0,1,32,0,32
Himachal Pradesh,"2 - Narcotic Drugs & Psychotropic Substances Act, 1985",2014,365,6,371,282,13,295,127,5,132,9,0,9,783,24,807
Himachal Pradesh,"3 - Gambling Act, 1867",2014,241,0,241,443,1,444,189,0,189,8,0,8,881,1,882
Himachal Pradesh,"4 - Excise Act, 1944",2014,333,21,354,645,60,705,444,34,478,34,0,34,1456,115,1571
Himachal Pradesh,5 - Prohibition Act,2014,0,0,0,0,0,0,0,0,0,0,0,0,0,0,0
Himachal Pradesh,6 - Explosives and Explosive Substances Act,2014,0,0,0,0,0,0,1,0,1,0,0,0,1,0,1
Himachal Pradesh,"7 - Immoral Traffic (Prevention) Act, 1956",2014,4,3,7,11,5,16,1,0,1,0,0,0,16,8,24
Himachal Pradesh,7.1 - Under Section 5,2014,2,2,4,3,1,4,1,0,1,0,0,0,6,3,9
Himachal Pradesh,7.2 - Under Section 6,2014,0,1,1,4,4,8,0,0,0,0,0,0,4,5,9
Himachal Pradesh,7.3 - Under Section 7,2014,0,0,0,0,0,0,0,0,0,0,0,0,0,0,0
Himachal Pradesh,7.4 - Under Section 8,2014,0,0,0,0,0,0,0,0,0,0,0,0,0,0,0
Himachal Pradesh,7.5 - Other Sections under ITP Act,2014,2,0,2,4,0,4,0,0,0,0,0,0,6,0,6
Himachal Pradesh,"8 - Indian Railways Act, 1989",2014,0,0,0,0,0,0,0,0,0,0,0,0,0,0,0
Himachal Pradesh,"9 - Registration of Foreigners Act, 1939",2014,1,1,2,8,0,8,2,0,2,0,0,0,11,1,12
Himachal Pradesh,"10 - Protection of Civil Rights Act, 1955",2014,2,0,2,14,0,14,7,2,9,2,0,2,25,2,27
Himachal Pradesh,10.1 - PCR Act for crimes committed against SCs,2014,2,0,2,13,0,13,7,2,9,2,0,2,24,2,26
Himachal Pradesh,10.2 - PCR Act for crimes committed against STs,2014,0,0,0,0,0,0,0,0,0,0,0,0,0,0,0
Himachal Pradesh,10.3 - PCR Act for crimes committed against Others,2014,0,0,0,1,0,1,0,0,0,0,0,0,1,0,1
Himachal Pradesh,"11 - Passport Act, 1967",2014,0,0,0,0,0,0,0,0,0,0,0,0,0,0,0
Himachal Pradesh,"12 - Essential Commodities Act, 1955",2014,2,0,2,13,0,13,3,0,3,0,0,0,18,0,18
Himachal Pradesh,"13 - Antiquities & Art Treasures Act, 1972",2014,0,0,0,0,0,0,0,0,0,0,0,0,0,0,0
Himachal Pradesh,"14 - Dowry Prohibition Act, 1961",2014,1,1,2,0,0,0,1,1,2,0,0,0,2,2,4
Himachal Pradesh,"15 - Indecent Representation of Women (Prohibition) Act, 1986",2014,0,0,0,0,0,0,0,0,0,0,0,0,0,0,0
Himachal Pradesh,"16 - Copyright Act, 1957",2014,0,0,0,4,0,4,0,0,0,0,0,0,4,0,4
Himachal Pradesh,17 - Commission of Sati Prevention Act 1987,2014,0,0,0,0,0,0,0,0,0,0,0,0,0,0,0
Himachal Pradesh,"18 - SC/ST (Prevention of Atrocities) Act, 1989)",2014,20,3,23,52,12,64,24,8,32,2,0,2,98,23,121
Himachal Pradesh,18.1 - POA Act for crimes committed against SCs,2014,17,3,20,42,11,53,23,7,30,2,0,2,84,21,105
Himachal Pradesh,18.2 - POA Act for crimes committed against STs,2014,3,0,3,10,1,11,1,1,2,0,0,0,14,2,16
Himachal Pradesh,"19 - Forest Act, 1927",2014,77,1,78,104,0,104,31,1,32,2,0,2,214,2,216
Himachal Pradesh,"20 - Prohibition of Child Marriage Act, 2006",2014,4,0,4,4,3,7,3,4,7,0,0,0,11,7,18
Himachal Pradesh,"21 - Protection of Women from Domestic Violence Act, 2005",2014,0,0,0,5,0,5,0,0,0,0,0,0,5,0,5
Himachal Pradesh,"22 - Information Technology Act, 2000",2014,5,0,5,6,1,7,1,0,1,0,0,0,12,1,13
Himachal Pradesh,"23 - Official Secrets Act, 1923",2014,0,0,0,0,0,0,0,0,0,0,0,0,0,0,0
Himachal Pradesh,"24 - Electricity Act, 2003",2014,0,0,0,0,0,0,0,0,0,0,0,0,0,0,0
Himachal Pradesh,"25 - Wildlife Protection Act, 1972",2014,8,0,8,5,0,5,6,0,6,0,0,0,19,0,19
Himachal Pradesh,"26 - Bonded Labour System (Abolition) Act, 1976",2014,1,0,1,0,0,0,1,0,1,0,0,0,2,0,2
Himachal Pradesh,26.1 - Against SCs,2014,0,0,0,0,0,0,0,0,0,0,0,0,0,0,0
Himachal Pradesh,26.2 - Against STs,2014,0,0,0,0,0,0,0,0,0,0,0,0,0,0,0
Himachal Pradesh,26.3 - Against others,2014,1,0,1,0,0,0,1,0,1,0,0,0,2,0,2
Himachal Pradesh,"27 - Environmental (Protection) Act, 1986",2014,1,0,1,1,0,1,0,0,0,0,0,0,2,0,2
Himachal Pradesh,"28 - Air (Prevention & Control of Pollution) Act, 1981",2014,0,0,0,0,0,0,0,0,0,0,0,0,0,0,0
Himachal Pradesh,"29 - Water (Prevention & Control of Pollution) Act, 1974(as amended in 1988)",2014,0,0,0,0,0,0,0,0,0,0,0,0,0,0,0
Himachal Pradesh,"30 - National Security Act, 1980",2014,0,0,0,0,0,0,0,0,0,0,0,0,0,0,0
Himachal Pradesh,"31 - Unlawful Activities (Prevention) Act, 1967",2014,0,0,0,0,0,0,0,0,0,0,0,0,0,0,0
Himachal Pradesh,"32 - Young Persons (Harmful Publications) Act, 1956",2014,0,0,0,0,0,0,0,0,0,0,0,0,0,0,0
Himachal Pradesh,"33 - Railway Property (Unlawful Possession) Act, 1966",2014,0,0,0,0,0,0,0,0,0,0,0,0,0,0,0
Himachal Pradesh,"34 - Prevention of Damage to Public Property Act, 1984",2014,17,3,20,47,13,60,14,4,18,0,0,0,78,20,98
Himachal Pradesh,"35 - Transplantation of Human Organs Act, 1994",2014,0,0,0,0,0,0,0,0,0,0,0,0,0,0,0
Himachal Pradesh,"36 - Trade Marks Act, 1999",2014,0,0,0,0,0,0,0,0,0,0,0,0,0,0,0
Himachal Pradesh,"37 - Prevention of Insults to National Honour Act, 1971",2014,1,0,1,2,0,2,0,0,0,0,0,0,3,0,3
Himachal Pradesh,"38 - State Emblem (Prohibition of Improper Use) Act, 2005",2014,0,0,0,0,0,0,0,0,0,0,0,0,0,0,0
Himachal Pradesh,"39 - Lotteries (Regulation) Act, 1998",2014,0,0,0,0,0,0,0,0,0,0,0,0,0,0,0
Himachal Pradesh,"40 - Citizenship Act, 1955",2014,0,0,0,0,0,0,0,0,0,0,0,0,0,0,0
Himachal Pradesh,"41 - Foreigners Act, 1946",2014,0,0,0,2,0,2,1,0,1,0,0,0,3,0,3
Himachal Pradesh,"42 - Place of Worship (Special Provisions) Act, 1991",2014,0,0,0,0,0,0,0,0,0,0,0,0,0,0,0
Himachal Pradesh,"43 - Religious Institution (Prevention of Misuse) Act, 1988",2014,0,0,0,0,0,0,0,0,0,0,0,0,0,0,0
Himachal Pradesh,"44 - Representation of People Act, 1951",2014,0,0,0,0,0,0,0,0,0,0,0,0,0,0,0
Himachal Pradesh,"45 - Emigration Act, 1983",2014,0,0,0,0,0,0,0,0,0,0,0,0,0,0,0
Himachal Pradesh,"46 - Juvenile Justice (Care and Protection of Children) Act, 2000",2014,2,0,2,4,0,4,0,3,3,2,1,3,8,4,12
Himachal Pradesh,"47 - Infant Substitutes Regulation Act, 2003",2014,0,0,0,0,0,0,0,0,0,0,0,0,0,0,0
Himachal Pradesh,"48 - Anti-Hijacking Act, 1982",2014,0,0,0,0,0,0,0,0,0,0,0,0,0,0,0
Himachal Pradesh,"49 - Atomic Energy Act, 1962",2014,0,0,0,0,0,0,0,0,0,0,0,0,0,0,0
Himachal Pradesh,"50 - Weapons of Mass Destruction (Proh. of Unlawful Activities) Act, 2005",2014,0,0,0,0,0,0,0,0,0,0,0,0,0,0,0
Himachal Pradesh,"51 - Suppression of Unlawful Acts against Safety of Civil Aviation Act, 1982",2014,0,0,0,0,0,0,0,0,0,0,0,0,0,0,0
Himachal Pradesh,"52 - Safety of Maritime Navigation Act, 2002",2014,0,0,0,0,0,0,0,0,0,0,0,0,0,0,0
Himachal Pradesh,"53 - Manual Scavengers and Construction of Dry Latrines (P) Act, 1993",2014,0,0,0,0,0,0,0,0,0,0,0,0,0,0,0
Himachal Pradesh,"54 - Pre-Natal Diagnostic Techniques (Reg and Prev of Misuse) Act, 1994",2014,0,0,0,0,0,0,0,0,0,0,0,0,0,0,0
Himachal Pradesh,"55 - The Maritime Zones of India (Reg of Fishing by Foreign Vessels) Act, 1981",2014,0,0,0,0,0,0,0,0,0,0,0,0,0,0,0
Himachal Pradesh,56 - Other SLL crimes,2014,57,2,59,76,6,82,34,4,38,4,1,5,171,13,184
Himachal Pradesh,57 - Total Cognizable SLL crimes,2014,1147,41,1188,1745,114,1859,899,66,965,64,2,66,3855,223,4078
Jammu & Kashmir,"1 - Arms Act, 1959",2014,82,0,82,74,1,75,3,0,3,0,0,0,159,1,160
Jammu & Kashmir,"2 - Narcotic Drugs & Psychotropic Substances Act, 1985",2014,178,1,179,360,3,363,45,0,45,0,0,0,583,4,587
Jammu & Kashmir,"3 - Gambling Act, 1867",2014,118,0,118,351,0,351,282,0,282,0,0,0,751,0,751
Jammu & Kashmir,"4 - Excise Act, 1944",2014,239,7,246,219,9,228,38,1,39,0,0,0,496,17,513
Jammu & Kashmir,5 - Prohibition Act,2014,0,0,0,0,0,0,0,0,0,0,0,0,0,0,0
Jammu & Kashmir,6 - Explosives and Explosive Substances Act,2014,6,0,6,12,0,12,2,0,2,0,0,0,20,0,20
Jammu & Kashmir,"7 - Immoral Traffic (Prevention) Act, 1956",2014,1,2,3,2,1,3,0,0,0,0,0,0,3,3,6
Jammu & Kashmir,7.1 - Under Section 5,2014,1,2,3,2,1,3,0,0,0,0,0,0,3,3,6
Jammu & Kashmir,7.2 - Under Section 6,2014,0,0,0,0,0,0,0,0,0,0,0,0,0,0,0
Jammu & Kashmir,7.3 - Under Section 7,2014,0,0,0,0,0,0,0,0,0,0,0,0,0,0,0
Jammu & Kashmir,7.4 - Under Section 8,2014,0,0,0,0,0,0,0,0,0,0,0,0,0,0,0
Jammu & Kashmir,7.5 - Other Sections under ITP Act,2014,0,0,0,0,0,0,0,0,0,0,0,0,0,0,0
Jammu & Kashmir,"8 - Indian Railways Act, 1989",2014,0,0,0,4,0,4,0,0,0,0,0,0,4,0,4
Jammu & Kashmir,"9 - Registration of Foreigners Act, 1939",2014,6,0,6,0,0,0,0,0,0,0,0,0,6,0,6
Jammu & Kashmir,"10 - Protection of Civil Rights Act, 1955",2014,0,0,0,0,0,0,0,0,0,0,0,0,0,0,0
Jammu & Kashmir,10.1 - PCR Act for crimes committed against SCs,2014,0,0,0,0,0,0,0,0,0,0,0,0,0,0,0
Jammu & Kashmir,10.2 - PCR Act for crimes committed against STs,2014,0,0,0,0,0,0,0,0,0,0,0,0,0,0,0
Jammu & Kashmir,10.3 - PCR Act for crimes committed against Others,2014,0,0,0,0,0,0,0,0,0,0,0,0,0,0,0
Jammu & Kashmir,"11 - Passport Act, 1967",2014,1,0,1,1,0,1,0,0,0,0,0,0,2,0,2
Jammu & Kashmir,"12 - Essential Commodities Act, 1955",2014,88,0,88,130,0,130,22,0,22,0,0,0,240,0,240
Jammu & Kashmir,"13 - Antiquities & Art Treasures Act, 1972",2014,0,0,0,0,0,0,0,0,0,0,0,0,0,0,0
Jammu & Kashmir,"14 - Dowry Prohibition Act, 1961",2014,0,0,0,1,0,1,0,0,0,0,0,0,1,0,1
Jammu & Kashmir,"15 - Indecent Representation of Women (Prohibition) Act, 1986",2014,0,0,0,0,0,0,0,0,0,0,0,0,0,0,0
Jammu & Kashmir,"16 - Copyright Act, 1957",2014,2,0,2,0,0,0,0,0,0,0,0,0,2,0,2
Jammu & Kashmir,17 - Commission of Sati Prevention Act 1987,2014,0,0,0,0,0,0,0,0,0,0,0,0,0,0,0
Jammu & Kashmir,"18 - SC/ST (Prevention of Atrocities) Act, 1989)",2014,0,0,0,0,0,0,0,0,0,0,0,0,0,0,0
Jammu & Kashmir,18.1 - POA Act for crimes committed against SCs,2014,0,0,0,0,0,0,0,0,0,0,0,0,0,0,0
Jammu & Kashmir,18.2 - POA Act for crimes committed against STs,2014,0,0,0,0,0,0,0,0,0,0,0,0,0,0,0
Jammu & Kashmir,"19 - Forest Act, 1927",2014,5,0,5,4,0,4,0,0,0,0,0,0,9,0,9
Jammu & Kashmir,"20 - Prohibition of Child Marriage Act, 2006",2014,0,0,0,0,0,0,0,0,0,0,0,0,0,0,0
Jammu & Kashmir,"21 - Protection of Women from Domestic Violence Act, 2005",2014,0,0,0,0,0,0,0,0,0,0,0,0,0,0,0
Jammu & Kashmir,"22 - Information Technology Act, 2000",2014,1,0,1,1,0,1,0,0,0,0,0,0,2,0,2
Jammu & Kashmir,"23 - Official Secrets Act, 1923",2014,0,0,0,0,0,0,0,0,0,0,0,0,0,0,0
Jammu & Kashmir,"24 - Electricity Act, 2003",2014,0,0,0,0,0,0,0,0,0,0,0,0,0,0,0
Jammu & Kashmir,"25 - Wildlife Protection Act, 1972",2014,0,0,0,0,0,0,0,0,0,0,0,0,0,0,0
Jammu & Kashmir,"26 - Bonded Labour System (Abolition) Act, 1976",2014,0,0,0,0,0,0,0,0,0,0,0,0,0,0,0
Jammu & Kashmir,26.1 - Against SCs,2014,0,0,0,0,0,0,0,0,0,0,0,0,0,0,0
Jammu & Kashmir,26.2 - Against STs,2014,0,0,0,0,0,0,0,0,0,0,0,0,0,0,0
Jammu & Kashmir,26.3 - Against others,2014,0,0,0,0,0,0,0,0,0,0,0,0,0,0,0
Jammu & Kashmir,"27 - Environmental (Protection) Act, 1986",2014,0,0,0,0,0,0,0,0,0,0,0,0,0,0,0
Jammu & Kashmir,"28 - Air (Prevention & Control of Pollution) Act, 1981",2014,0,0,0,0,0,0,0,0,0,0,0,0,0,0,0
Jammu & Kashmir,"29 - Water (Prevention & Control of Pollution) Act, 1974(as amended in 1988)",2014,0,0,0,0,0,0,0,0,0,0,0,0,0,0,0
Jammu & Kashmir,"30 - National Security Act, 1980",2014,0,0,0,0,0,0,0,0,0,0,0,0,0,0,0
Jammu & Kashmir,"31 - Unlawful Activities (Prevention) Act, 1967",2014,8,0,8,7,2,9,0,0,0,0,0,0,15,2,17
Jammu & Kashmir,"32 - Young Persons (Harmful Publications) Act, 1956",2014,0,0,0,0,0,0,0,0,0,0,0,0,0,0,0
Jammu & Kashmir,"33 - Railway Property (Unlawful Possession) Act, 1966",2014,0,0,0,0,0,0,0,0,0,0,0,0,0,0,0
Jammu & Kashmir,"34 - Prevention of Damage to Public Property Act, 1984",2014,0,0,0,3,0,3,1,0,1,1,0,1,5,0,5
Jammu & Kashmir,"35 - Transplantation of Human Organs Act, 1994",2014,0,0,0,0,0,0,0,0,0,0,0,0,0,0,0
Jammu & Kashmir,"36 - Trade Marks Act, 1999",2014,0,0,0,0,0,0,0,0,0,0,0,0,0,0,0
Jammu & Kashmir,"37 - Prevention of Insults to National Honour Act, 1971",2014,0,0,0,0,0,0,0,0,0,0,0,0,0,0,0
Jammu & Kashmir,"38 - State Emblem (Prohibition of Improper Use) Act, 2005",2014,0,0,0,0,0,0,0,0,0,0,0,0,0,0,0
Jammu & Kashmir,"39 - Lotteries (Regulation) Act, 1998",2014,0,0,0,0,0,0,0,0,0,0,0,0,0,0,0
Jammu & Kashmir,"40 - Citizenship Act, 1955",2014,0,0,0,0,0,0,0,0,0,0,0,0,0,0,0
Jammu & Kashmir,"41 - Foreigners Act, 1946",2014,0,0,0,0,0,0,0,0,0,0,0,0,0,0,0
Jammu & Kashmir,"42 - Place of Worship (Special Provisions) Act, 1991",2014,0,0,0,0,0,0,0,0,0,0,0,0,0,0,0
Jammu & Kashmir,"43 - Religious Institution (Prevention of Misuse) Act, 1988",2014,0,0,0,0,0,0,0,0,0,0,0,0,0,0,0
Jammu & Kashmir,"44 - Representation of People Act, 1951",2014,0,0,0,0,0,0,0,0,0,0,0,0,0,0,0
Jammu & Kashmir,"45 - Emigration Act, 1983",2014,0,0,0,0,0,0,0,0,0,0,0,0,0,0,0
Jammu & Kashmir,"46 - Juvenile Justice (Care and Protection of Children) Act, 2000",2014,0,0,0,0,0,0,0,0,0,0,0,0,0,0,0
Jammu & Kashmir,"47 - Infant Substitutes Regulation Act, 2003",2014,0,0,0,0,0,0,0,0,0,0,0,0,0,0,0
Jammu & Kashmir,"48 - Anti-Hijacking Act, 1982",2014,0,0,0,0,0,0,0,0,0,0,0,0,0,0,0
Jammu & Kashmir,"49 - Atomic Energy Act, 1962",2014,0,0,0,0,0,0,0,0,0,0,0,0,0,0,0
Jammu & Kashmir,"50 - Weapons of Mass Destruction (Proh. of Unlawful Activities) Act, 2005",2014,0,0,0,0,0,0,0,0,0,0,0,0,0,0,0
Jammu & Kashmir,"51 - Suppression of Unlawful Acts against Safety of Civil Aviation Act, 1982",2014,0,0,0,0,0,0,0,0,0,0,0,0,0,0,0
Jammu & Kashmir,"52 - Safety of Maritime Navigation Act, 2002",2014,0,0,0,0,0,0,0,0,0,0,0,0,0,0,0
Jammu & Kashmir,"53 - Manual Scavengers and Construction of Dry Latrines (P) Act, 1993",2014,0,0,0,0,0,0,0,0,0,0,0,0,0,0,0
Jammu & Kashmir,"54 - Pre-Natal Diagnostic Techniques (Reg and Prev of Misuse) Act, 1994",2014,0,0,0,0,0,0,0,0,0,0,0,0,0,0,0
Jammu & Kashmir,"55 - The Maritime Zones of India (Reg of Fishing by Foreign Vessels) Act, 1981",2014,0,0,0,0,0,0,0,0,0,0,0,0,0,0,0
Jammu & Kashmir,56 - Other SLL crimes,2014,45,0,45,109,1,110,24,0,24,1,0,1,179,1,180
Jammu & Kashmir,57 - Total Cognizable SLL crimes,2014,780,10,790,1278,17,1295,417,1,418,2,0,2,2477,28,2505
Jharkhand,"1 - Arms Act, 1959",2014,267,1,268,323,0,323,42,0,42,0,0,0,632,1,633
Jharkhand,"2 - Narcotic Drugs & Psychotropic Substances Act, 1985",2014,77,0,77,81,0,81,11,0,11,0,0,0,169,0,169
Jharkhand,"3 - Gambling Act, 1867",2014,61,0,61,95,0,95,19,0,19,0,0,0,175,0,175
Jharkhand,"4 - Excise Act, 1944",2014,161,0,161,306,1,307,136,0,136,1,0,1,604,1,605
Jharkhand,5 - Prohibition Act,2014,0,0,0,3,0,3,0,0,0,0,0,0,3,0,3
Jharkhand,6 - Explosives and Explosive Substances Act,2014,39,0,39,91,0,91,4,0,4,0,0,0,134,0,134
Jharkhand,"7 - Immoral Traffic (Prevention) Act, 1956",2014,3,1,4,10,0,10,0,0,0,0,0,0,13,1,14
Jharkhand,7.1 - Under Section 5,2014,0,0,0,5,0,5,0,0,0,0,0,0,5,0,5
Jharkhand,7.2 - Under Section 6,2014,0,1,1,0,0,0,0,0,0,0,0,0,0,1,1
Jharkhand,7.3 - Under Section 7,2014,0,0,0,0,0,0,0,0,0,0,0,0,0,0,0
Jharkhand,7.4 - Under Section 8,2014,0,0,0,0,0,0,0,0,0,0,0,0,0,0,0
Jharkhand,7.5 - Other Sections under ITP Act,2014,3,0,3,5,0,5,0,0,0,0,0,0,8,0,8
Jharkhand,"8 - Indian Railways Act, 1989",2014,0,0,0,0,0,0,0,0,0,0,0,0,0,0,0
Jharkhand,"9 - Registration of Foreigners Act, 1939",2014,0,0,0,3,0,3,0,0,0,0,0,0,3,0,3
Jharkhand,"10 - Protection of Civil Rights Act, 1955",2014,0,0,0,0,0,0,0,0,0,0,0,0,0,0,0
Jharkhand,10.1 - PCR Act for crimes committed against SCs,2014,0,0,0,0,0,0,0,0,0,0,0,0,0,0,0
Jharkhand,10.2 - PCR Act for crimes committed against STs,2014,0,0,0,0,0,0,0,0,0,0,0,0,0,0,0
Jharkhand,10.3 - PCR Act for crimes committed against Others,2014,0,0,0,0,0,0,0,0,0,0,0,0,0,0,0
Jharkhand,"11 - Passport Act, 1967",2014,0,0,0,3,0,3,0,0,0,0,0,0,3,0,3
Jharkhand,"12 - Essential Commodities Act, 1955",2014,15,0,15,77,2,79,21,0,21,0,0,0,113,2,115
Jharkhand,"13 - Antiquities & Art Treasures Act, 1972",2014,0,0,0,4,0,4,0,0,0,0,0,0,4,0,4
Jharkhand,"14 - Dowry Prohibition Act, 1961",2014,465,52,517,579,97,676,192,77,269,3,2,5,1239,228,1467
Jharkhand,"15 - Indecent Representation of Women (Prohibition) Act, 1986",2014,0,0,0,0,0,0,0,0,0,0,0,0,0,0,0
Jharkhand,"16 - Copyright Act, 1957",2014,4,0,4,15,0,15,0,0,0,0,0,0,19,0,19
Jharkhand,17 - Commission of Sati Prevention Act 1987,2014,0,0,0,0,0,0,0,0,0,0,0,0,0,0,0
Jharkhand,"18 - SC/ST (Prevention of Atrocities) Act, 1989)",2014,213,3,216,513,8,521,162,3,165,5,0,5,893,14,907
Jharkhand,18.1 - POA Act for crimes committed against SCs,2014,144,2,146,373,8,381,106,2,108,5,0,5,628,12,640
Jharkhand,18.2 - POA Act for crimes committed against STs,2014,69,1,70,140,0,140,56,1,57,0,0,0,265,2,267
Jharkhand,"19 - Forest Act, 1927",2014,52,1,53,178,0,178,52,0,52,0,0,0,282,1,283
Jharkhand,"20 - Prohibition of Child Marriage Act, 2006",2014,0,0,0,1,0,1,0,0,0,0,0,0,1,0,1
Jharkhand,"21 - Protection of Women from Domestic Violence Act, 2005",2014,2,0,2,2,0,2,0,0,0,0,0,0,4,0,4
Jharkhand,"22 - Information Technology Act, 2000",2014,32,0,32,22,0,22,3,0,3,0,0,0,57,0,57
Jharkhand,"23 - Official Secrets Act, 1923",2014,0,0,0,0,0,0,0,0,0,0,0,0,0,0,0
Jharkhand,"24 - Electricity Act, 2003",2014,202,2,204,557,15,572,333,7,340,0,0,0,1092,24,1116
Jharkhand,"25 - Wildlife Protection Act, 1972",2014,0,0,0,0,0,0,0,0,0,0,0,0,0,0,0
Jharkhand,"26 - Bonded Labour System (Abolition) Act, 1976",2014,0,0,0,0,0,0,0,0,0,0,0,0,0,0,0
Jharkhand,26.1 - Against SCs,2014,0,0,0,0,0,0,0,0,0,0,0,0,0,0,0
Jharkhand,26.2 - Against STs,2014,0,0,0,0,0,0,0,0,0,0,0,0,0,0,0
Jharkhand,26.3 - Against others,2014,0,0,0,0,0,0,0,0,0,0,0,0,0,0,0
Jharkhand,"27 - Environmental (Protection) Act, 1986",2014,0,0,0,0,0,0,0,0,0,0,0,0,0,0,0
Jharkhand,"28 - Air (Prevention & Control of Pollution) Act, 1981",2014,0,0,0,4,0,4,0,0,0,0,0,0,4,0,4
Jharkhand,"29 - Water (Prevention & Control of Pollution) Act, 1974(as amended in 1988)",2014,0,0,0,0,0,0,0,0,0,0,0,0,0,0,0
Jharkhand,"30 - National Security Act, 1980",2014,0,0,0,0,0,0,0,0,0,0,0,0,0,0,0
Jharkhand,"31 - Unlawful Activities (Prevention) Act, 1967",2014,22,0,22,3,0,3,4,0,4,0,0,0,29,0,29
Jharkhand,"32 - Young Persons (Harmful Publications) Act, 1956",2014,0,0,0,0,0,0,0,0,0,0,0,0,0,0,0
Jharkhand,"33 - Railway Property (Unlawful Possession) Act, 1966",2014,0,0,0,0,0,0,0,0,0,0,0,0,0,0,0
Jharkhand,"34 - Prevention of Damage to Public Property Act, 1984",2014,3,0,3,28,0,28,21,0,21,0,0,0,52,0,52
Jharkhand,"35 - Transplantation of Human Organs Act, 1994",2014,0,0,0,0,0,0,0,0,0,0,0,0,0,0,0
Jharkhand,"36 - Trade Marks Act, 1999",2014,0,0,0,1,0,1,0,0,0,0,0,0,1,0,1
Jharkhand,"37 - Prevention of Insults to National Honour Act, 1971",2014,0,0,0,0,0,0,0,0,0,0,0,0,0,0,0
Jharkhand,"38 - State Emblem (Prohibition of Improper Use) Act, 2005",2014,0,0,0,0,0,0,0,0,0,0,0,0,0,0,0
Jharkhand,"39 - Lotteries (Regulation) Act, 1998",2014,0,0,0,3,0,3,0,0,0,0,0,0,3,0,3
Jharkhand,"40 - Citizenship Act, 1955",2014,0,0,0,0,0,0,0,0,0,0,0,0,0,0,0
Jharkhand,"41 - Foreigners Act, 1946",2014,0,0,0,0,0,0,0,0,0,0,0,0,0,0,0
Jharkhand,"42 - Place of Worship (Special Provisions) Act, 1991",2014,0,0,0,0,0,0,0,0,0,0,0,0,0,0,0
Jharkhand,"43 - Religious Institution (Prevention of Misuse) Act, 1988",2014,0,0,0,0,0,0,0,0,0,0,0,0,0,0,0
Jharkhand,"44 - Representation of People Act, 1951",2014,5,0,5,12,0,12,3,0,3,0,0,0,20,0,20
Jharkhand,"45 - Emigration Act, 1983",2014,0,0,0,0,0,0,0,0,0,0,0,0,0,0,0
Jharkhand,"46 - Juvenile Justice (Care and Protection of Children) Act, 2000",2014,0,0,0,0,0,0,0,0,0,0,0,0,0,0,0
Jharkhand,"47 - Infant Substitutes Regulation Act, 2003",2014,0,0,0,0,0,0,0,0,0,0,0,0,0,0,0
Jharkhand,"48 - Anti-Hijacking Act, 1982",2014,0,0,0,0,0,0,0,0,0,0,0,0,0,0,0
Jharkhand,"49 - Atomic Energy Act, 1962",2014,0,0,0,0,0,0,0,0,0,0,0,0,0,0,0
Jharkhand,"50 - Weapons of Mass Destruction (Proh. of Unlawful Activities) Act, 2005",2014,0,0,0,0,0,0,0,0,0,0,0,0,0,0,0
Jharkhand,"51 - Suppression of Unlawful Acts against Safety of Civil Aviation Act, 1982",2014,0,0,0,0,0,0,0,0,0,0,0,0,0,0,0
Jharkhand,"52 - Safety of Maritime Navigation Act, 2002",2014,0,0,0,0,0,0,0,0,0,0,0,0,0,0,0
Jharkhand,"53 - Manual Scavengers and Construction of Dry Latrines (P) Act, 1993",2014,0,0,0,0,0,0,0,0,0,0,0,0,0,0,0
Jharkhand,"54 - Pre-Natal Diagnostic Techniques (Reg and Prev of Misuse) Act, 1994",2014,0,0,0,0,0,0,0,0,0,0,0,0,0,0,0
Jharkhand,"55 - The Maritime Zones of India (Reg of Fishing by Foreign Vessels) Act, 1981",2014,0,0,0,0,0,0,0,0,0,0,0,0,0,0,0
Jharkhand,56 - Other SLL crimes,2014,693,11,704,1296,35,1331,286,10,296,1,0,1,2276,56,2332
Jharkhand,57 - Total Cognizable SLL crimes,2014,2316,71,2387,4210,158,4368,1289,97,1386,10,2,12,7825,328,8153
Karnataka,"1 - Arms Act, 1959",2014,77,0,77,147,1,148,34,0,34,1,0,1,259,1,260
Karnataka,"2 - Narcotic Drugs & Psychotropic Substances Act, 1985",2014,215,3,218,195,3,198,64,6,70,7,2,9,481,14,495
Karnataka,"3 - Gambling Act, 1867",2014,15504,8,15512,18384,16,18400,7980,5,7985,772,0,772,42640,29,42669
Karnataka,"4 - Excise Act, 1944",2014,2278,9,2287,2158,53,2211,795,30,825,43,6,49,5274,98,5372
Karnataka,5 - Prohibition Act,2014,0,0,0,0,0,0,0,0,0,0,0,0,0,0,0
Karnataka,6 - Explosives and Explosive Substances Act,2014,37,0,37,120,1,121,34,0,34,2,0,2,193,1,194
Karnataka,"7 - Immoral Traffic (Prevention) Act, 1956",2014,400,78,478,396,66,462,92,25,117,4,5,9,892,174,1066
Karnataka,7.1 - Under Section 5,2014,135,21,156,101,19,120,31,7,38,3,2,5,270,49,319
Karnataka,7.2 - Under Section 6,2014,7,0,7,3,0,3,0,0,0,0,0,0,10,0,10
Karnataka,7.3 - Under Section 7,2014,36,7,43,35,4,39,14,4,18,0,1,1,85,16,101
Karnataka,7.4 - Under Section 8,2014,12,5,17,20,6,26,0,1,1,0,0,0,32,12,44
Karnataka,7.5 - Other Sections under ITP Act,2014,210,45,255,237,37,274,47,13,60,1,2,3,495,97,592
Karnataka,"8 - Indian Railways Act, 1989",2014,5,0,5,0,0,0,0,0,0,0,0,0,5,0,5
Karnataka,"9 - Registration of Foreigners Act, 1939",2014,6,0,6,1,1,2,1,0,1,0,0,0,8,1,9
Karnataka,"10 - Protection of Civil Rights Act, 1955",2014,0,0,0,0,0,0,0,0,0,0,0,0,0,0,0
Karnataka,10.1 - PCR Act for crimes committed against SCs,2014,0,0,0,0,0,0,0,0,0,0,0,0,0,0,0
Karnataka,10.2 - PCR Act for crimes committed against STs,2014,0,0,0,0,0,0,0,0,0,0,0,0,0,0,0
Karnataka,10.3 - PCR Act for crimes committed against Others,2014,0,0,0,0,0,0,0,0,0,0,0,0,0,0,0
Karnataka,"11 - Passport Act, 1967",2014,12,2,14,12,5,17,1,0,1,0,0,0,25,7,32
Karnataka,"12 - Essential Commodities Act, 1955",2014,333,1,334,529,4,533,146,1,147,8,0,8,1016,6,1022
Karnataka,"13 - Antiquities & Art Treasures Act, 1972",2014,8,0,8,10,0,10,2,0,2,0,0,0,20,0,20
Karnataka,"14 - Dowry Prohibition Act, 1961",2014,820,218,1038,1226,499,1725,514,408,922,131,59,190,2691,1184,3875
Karnataka,"15 - Indecent Representation of Women (Prohibition) Act, 1986",2014,0,0,0,0,0,0,0,0,0,0,0,0,0,0,0
Karnataka,"16 - Copyright Act, 1957",2014,210,1,211,194,3,197,25,0,25,1,0,1,430,4,434
Karnataka,17 - Commission of Sati Prevention Act 1987,2014,0,0,0,0,0,0,0,0,0,0,0,0,0,0,0
Karnataka,"18 - SC/ST (Prevention of Atrocities) Act, 1989)",2014,1389,55,1444,1553,127,1680,864,56,920,73,9,82,3879,247,4126
Karnataka,18.1 - POA Act for crimes committed against SCs,2014,1044,51,1095,1257,101,1358,760,48,808,68,8,76,3129,208,3337
Karnataka,18.2 - POA Act for crimes committed against STs,2014,345,4,349,296,26,322,104,8,112,5,1,6,750,39,789
Karnataka,"19 - Forest Act, 1927",2014,83,0,83,153,0,153,24,0,24,1,0,1,261,0,261
Karnataka,"20 - Prohibition of Child Marriage Act, 2006",2014,16,0,16,35,5,40,5,3,8,2,0,2,58,8,66
Karnataka,"21 - Protection of Women from Domestic Violence Act, 2005",2014,0,0,0,0,0,0,0,0,0,0,0,0,0,0,0
Karnataka,"22 - Information Technology Act, 2000",2014,162,6,168,162,4,166,16,2,18,2,0,2,342,12,354
Karnataka,"23 - Official Secrets Act, 1923",2014,0,0,0,0,0,0,0,0,0,0,0,0,0,0,0
Karnataka,"24 - Electricity Act, 2003",2014,3,0,3,4,0,4,3,0,3,0,0,0,10,0,10
Karnataka,"25 - Wildlife Protection Act, 1972",2014,34,0,34,80,1,81,16,0,16,1,0,1,131,1,132
Karnataka,"26 - Bonded Labour System (Abolition) Act, 1976",2014,4,0,4,22,0,22,3,0,3,0,0,0,29,0,29
Karnataka,26.1 - Against SCs,2014,0,0,0,1,0,1,0,0,0,0,0,0,1,0,1
Karnataka,26.2 - Against STs,2014,0,0,0,0,0,0,0,0,0,0,0,0,0,0,0
Karnataka,26.3 - Against others,2014,4,0,4,21,0,21,3,0,3,0,0,0,28,0,28
Karnataka,"27 - Environmental (Protection) Act, 1986",2014,0,0,0,0,0,0,0,0,0,0,0,0,0,0,0
Karnataka,"28 - Air (Prevention & Control of Pollution) Act, 1981",2014,0,0,0,0,0,0,0,0,0,0,0,0,0,0,0
Karnataka,"29 - Water (Prevention & Control of Pollution) Act, 1974(as amended in 1988)",2014,0,0,0,0,0,0,0,0,0,0,0,0,0,0,0
Karnataka,"30 - National Security Act, 1980",2014,0,0,0,0,0,0,0,0,0,0,0,0,0,0,0
Karnataka,"31 - Unlawful Activities (Prevention) Act, 1967",2014,0,0,0,1,0,1,0,0,0,0,0,0,1,0,1
Karnataka,"32 - Young Persons (Harmful Publications) Act, 1956",2014,0,0,0,0,0,0,0,0,0,0,0,0,0,0,0
Karnataka,"33 - Railway Property (Unlawful Possession) Act, 1966",2014,0,0,0,0,0,0,0,0,0,0,0,0,0,0,0
Karnataka,"34 - Prevention of Damage to Public Property Act, 1984",2014,33,0,33,27,0,27,3,0,3,0,0,0,63,0,63
Karnataka,"35 - Transplantation of Human Organs Act, 1994",2014,0,0,0,0,0,0,0,0,0,0,0,0,0,0,0
Karnataka,"36 - Trade Marks Act, 1999",2014,0,0,0,0,0,0,0,0,0,0,0,0,0,0,0
Karnataka,"37 - Prevention of Insults to National Honour Act, 1971",2014,2,0,2,4,0,4,1,0,1,0,0,0,7,0,7
Karnataka,"38 - State Emblem (Prohibition of Improper Use) Act, 2005",2014,0,0,0,0,0,0,0,0,0,0,0,0,0,0,0
Karnataka,"39 - Lotteries (Regulation) Act, 1998",2014,0,0,0,4,0,4,0,0,0,0,0,0,4,0,4
Karnataka,"40 - Citizenship Act, 1955",2014,0,0,0,0,0,0,0,0,0,0,0,0,0,0,0
Karnataka,"41 - Foreigners Act, 1946",2014,49,4,53,34,5,39,10,1,11,0,0,0,93,10,103
Karnataka,"42 - Place of Worship (Special Provisions) Act, 1991",2014,0,0,0,0,0,0,0,0,0,0,0,0,0,0,0
Karnataka,"43 - Religious Institution (Prevention of Misuse) Act, 1988",2014,0,0,0,0,0,0,0,0,0,0,0,0,0,0,0
Karnataka,"44 - Representation of People Act, 1951",2014,70,1,71,192,4,196,49,0,49,2,0,2,313,5,318
Karnataka,"45 - Emigration Act, 1983",2014,0,0,0,0,0,0,0,0,0,0,0,0,0,0,0
Karnataka,"46 - Juvenile Justice (Care and Protection of Children) Act, 2000",2014,5,5,10,43,3,46,12,3,15,2,0,2,62,11,73
Karnataka,"47 - Infant Substitutes Regulation Act, 2003",2014,0,0,0,0,0,0,0,0,0,0,0,0,0,0,0
Karnataka,"48 - Anti-Hijacking Act, 1982",2014,0,0,0,0,0,0,0,0,0,0,0,0,0,0,0
Karnataka,"49 - Atomic Energy Act, 1962",2014,0,0,0,0,0,0,0,0,0,0,0,0,0,0,0
Karnataka,"50 - Weapons of Mass Destruction (Proh. of Unlawful Activities) Act, 2005",2014,0,0,0,0,0,0,0,0,0,0,0,0,0,0,0
Karnataka,"51 - Suppression of Unlawful Acts against Safety of Civil Aviation Act, 1982",2014,0,0,0,0,0,0,0,0,0,0,0,0,0,0,0
Karnataka,"52 - Safety of Maritime Navigation Act, 2002",2014,0,0,0,0,0,0,0,0,0,0,0,0,0,0,0
Karnataka,"53 - Manual Scavengers and Construction of Dry Latrines (P) Act, 1993",2014,0,0,0,0,0,0,0,0,0,0,0,0,0,0,0
Karnataka,"54 - Pre-Natal Diagnostic Techniques (Reg and Prev of Misuse) Act, 1994",2014,0,0,0,0,0,0,0,0,0,0,0,0,0,0,0
Karnataka,"55 - The Maritime Zones of India (Reg of Fishing by Foreign Vessels) Act, 1981",2014,0,0,0,0,0,0,0,0,0,0,0,0,0,0,0
Karnataka,56 - Other SLL crimes,2014,3177,29,3206,3846,57,3903,1806,14,1820,45,1,46,8874,101,8975
Karnataka,57 - Total Cognizable SLL crimes,2014,24932,420,25352,29532,858,30390,12500,554,13054,1097,82,1179,68061,1914,69975
Kerala,"1 - Arms Act, 1959",2014,118,0,118,187,0,187,83,0,83,9,0,9,397,0,397
Kerala,"2 - Narcotic Drugs & Psychotropic Substances Act, 1985",2014,1233,2,1235,936,10,946,414,8,422,61,3,64,2644,23,2667
Kerala,"3 - Gambling Act, 1867",2014,3499,0,3499,7687,0,7687,4916,0,4916,532,0,532,16634,0,16634
Kerala,"4 - Excise Act, 1944",2014,0,0,0,0,0,0,0,0,0,0,0,0,0,0,0
Kerala,5 - Prohibition Act,2014,20007,10,20017,24892,49,24941,14477,22,14499,2597,0,2597,61973,81,62054
Kerala,6 - Explosives and Explosive Substances Act,2014,66,0,66,304,2,306,150,2,152,15,0,15,535,4,539
Kerala,"7 - Immoral Traffic (Prevention) Act, 1956",2014,38,41,79,92,91,183,44,19,63,2,0,2,176,151,327
Kerala,7.1 - Under Section 5,2014,13,10,23,23,14,37,7,1,8,0,0,0,43,25,68
Kerala,7.2 - Under Section 6,2014,0,0,0,0,0,0,3,3,6,0,0,0,3,3,6
Kerala,7.3 - Under Section 7,2014,13,8,21,23,8,31,26,0,26,1,0,1,63,16,79
Kerala,7.4 - Under Section 8,2014,9,14,23,18,40,58,2,10,12,0,0,0,29,64,93
Kerala,7.5 - Other Sections under ITP Act,2014,3,9,12,28,29,57,6,5,11,1,0,1,38,43,81
Kerala,"8 - Indian Railways Act, 1989",2014,2,0,2,1,0,1,0,0,0,0,0,0,3,0,3
Kerala,"9 - Registration of Foreigners Act, 1939",2014,13,0,13,24,0,24,9,1,10,1,0,1,47,1,48
Kerala,"10 - Protection of Civil Rights Act, 1955",2014,0,0,0,0,0,0,0,0,0,0,0,0,0,0,0
Kerala,10.1 - PCR Act for crimes committed against SCs,2014,0,0,0,0,0,0,0,0,0,0,0,0,0,0,0
Kerala,10.2 - PCR Act for crimes committed against STs,2014,0,0,0,0,0,0,0,0,0,0,0,0,0,0,0
Kerala,10.3 - PCR Act for crimes committed against Others,2014,0,0,0,0,0,0,0,0,0,0,0,0,0,0,0
Kerala,"11 - Passport Act, 1967",2014,43,0,43,149,7,156,111,2,113,2,0,2,305,9,314
Kerala,"12 - Essential Commodities Act, 1955",2014,46,0,46,201,2,203,84,0,84,9,0,9,340,2,342
Kerala,"13 - Antiquities & Art Treasures Act, 1972",2014,0,0,0,0,0,0,0,0,0,0,0,0,0,0,0
Kerala,"14 - Dowry Prohibition Act, 1961",2014,1,0,1,4,2,6,0,1,1,0,0,0,5,3,8
Kerala,"15 - Indecent Representation of Women (Prohibition) Act, 1986",2014,2,0,2,5,0,5,3,0,3,0,0,0,10,0,10
Kerala,"16 - Copyright Act, 1957",2014,42,0,42,71,0,71,20,0,20,0,0,0,133,0,133
Kerala,17 - Commission of Sati Prevention Act 1987,2014,0,0,0,0,0,0,0,0,0,0,0,0,0,0,0
Kerala,"18 - SC/ST (Prevention of Atrocities) Act, 1989)",2014,6,0,6,19,2,21,10,0,10,0,1,1,35,3,38
Kerala,18.1 - POA Act for crimes committed against SCs,2014,4,0,4,17,2,19,10,0,10,0,1,1,31,3,34
Kerala,18.2 - POA Act for crimes committed against STs,2014,2,0,2,2,0,2,0,0,0,0,0,0,4,0,4
Kerala,"19 - Forest Act, 1927",2014,0,0,0,2,0,2,0,0,0,0,0,0,2,0,2
Kerala,"20 - Prohibition of Child Marriage Act, 2006",2014,15,0,15,16,7,23,3,0,3,0,0,0,34,7,41
Kerala,"21 - Protection of Women from Domestic Violence Act, 2005",2014,3,0,3,70,2,72,38,3,41,0,0,0,111,5,116
Kerala,"22 - Information Technology Act, 2000",2014,95,0,95,126,0,126,22,0,22,0,0,0,243,0,243
Kerala,"23 - Official Secrets Act, 1923",2014,0,0,0,0,0,0,0,0,0,0,0,0,0,0,0
Kerala,"24 - Electricity Act, 2003",2014,1,0,1,25,0,25,17,0,17,2,0,2,45,0,45
Kerala,"25 - Wildlife Protection Act, 1972",2014,0,0,0,2,0,2,0,0,0,1,0,1,3,0,3
Kerala,"26 - Bonded Labour System (Abolition) Act, 1976",2014,0,0,0,0,0,0,0,0,0,0,0,0,0,0,0
Kerala,26.1 - Against SCs,2014,0,0,0,0,0,0,0,0,0,0,0,0,0,0,0
Kerala,26.2 - Against STs,2014,0,0,0,0,0,0,0,0,0,0,0,0,0,0,0
Kerala,26.3 - Against others,2014,0,0,0,0,0,0,0,0,0,0,0,0,0,0,0
Kerala,"27 - Environmental (Protection) Act, 1986",2014,0,0,0,0,0,0,0,0,0,0,0,0,0,0,0
Kerala,"28 - Air (Prevention & Control of Pollution) Act, 1981",2014,0,0,0,0,0,0,0,0,0,0,0,0,0,0,0
Kerala,"29 - Water (Prevention & Control of Pollution) Act, 1974(as amended in 1988)",2014,0,0,0,0,0,0,1,0,1,0,0,0,1,0,1
Kerala,"30 - National Security Act, 1980",2014,0,0,0,0,0,0,0,0,0,0,0,0,0,0,0
Kerala,"31 - Unlawful Activities (Prevention) Act, 1967",2014,0,0,0,0,0,0,0,0,0,0,0,0,0,0,0
Kerala,"32 - Young Persons (Harmful Publications) Act, 1956",2014,0,0,0,6,0,6,1,0,1,0,0,0,7,0,7
Kerala,"33 - Railway Property (Unlawful Possession) Act, 1966",2014,0,0,0,0,0,0,0,0,0,0,0,0,0,0,0
Kerala,"34 - Prevention of Damage to Public Property Act, 1984",2014,147,0,147,148,0,148,39,0,39,0,0,0,334,0,334
Kerala,"35 - Transplantation of Human Organs Act, 1994",2014,0,0,0,0,0,0,0,0,0,0,0,0,0,0,0
Kerala,"36 - Trade Marks Act, 1999",2014,0,0,0,0,0,0,0,0,0,0,0,0,0,0,0
Kerala,"37 - Prevention of Insults to National Honour Act, 1971",2014,6,0,6,23,0,23,5,0,5,0,0,0,34,0,34
Kerala,"38 - State Emblem (Prohibition of Improper Use) Act, 2005",2014,0,0,0,0,0,0,0,0,0,0,0,0,0,0,0
Kerala,"39 - Lotteries (Regulation) Act, 1998",2014,2,0,2,29,0,29,11,0,11,0,0,0,42,0,42
Kerala,"40 - Citizenship Act, 1955",2014,0,0,0,0,0,0,0,0,0,0,0,0,0,0,0
Kerala,"41 - Foreigners Act, 1946",2014,0,0,0,0,0,0,0,0,0,0,0,0,0,0,0
Kerala,"42 - Place of Worship (Special Provisions) Act, 1991",2014,0,0,0,0,0,0,0,0,0,0,0,0,0,0,0
Kerala,"43 - Religious Institution (Prevention of Misuse) Act, 1988",2014,0,0,0,0,0,0,0,0,0,0,0,0,0,0,0
Kerala,"44 - Representation of People Act, 1951",2014,1,0,1,2,0,2,0,0,0,0,0,0,3,0,3
Kerala,"45 - Emigration Act, 1983",2014,0,0,0,3,0,3,4,0,4,0,0,0,7,0,7
Kerala,"46 - Juvenile Justice (Care and Protection of Children) Act, 2000",2014,25,1,26,127,17,144,69,8,77,2,0,2,223,26,249
Kerala,"47 - Infant Substitutes Regulation Act, 2003",2014,0,0,0,0,0,0,0,0,0,0,0,0,0,0,0
Kerala,"48 - Anti-Hijacking Act, 1982",2014,0,0,0,0,0,0,0,0,0,0,0,0,0,0,0
Kerala,"49 - Atomic Energy Act, 1962",2014,0,0,0,0,0,0,0,0,0,0,0,0,0,0,0
Kerala,"50 - Weapons of Mass Destruction (Proh. of Unlawful Activities) Act, 2005",2014,0,0,0,0,0,0,0,0,0,0,0,0,0,0,0
Kerala,"51 - Suppression of Unlawful Acts against Safety of Civil Aviation Act, 1982",2014,0,0,0,0,0,0,0,0,0,0,0,0,0,0,0
Kerala,"52 - Safety of Maritime Navigation Act, 2002",2014,0,0,0,0,0,0,0,0,0,0,0,0,0,0,0
Kerala,"53 - Manual Scavengers and Construction of Dry Latrines (P) Act, 1993",2014,0,0,0,0,0,0,0,0,0,0,0,0,0,0,0
Kerala,"54 - Pre-Natal Diagnostic Techniques (Reg and Prev of Misuse) Act, 1994",2014,0,0,0,0,0,0,0,0,0,0,0,0,0,0,0
Kerala,"55 - The Maritime Zones of India (Reg of Fishing by Foreign Vessels) Act, 1981",2014,0,0,0,0,0,0,0,0,0,0,0,0,0,0,0
Kerala,56 - Other SLL crimes,2014,133147,344,133491,143696,245,143941,74870,110,74980,9042,6,9048,360755,705,361460
Kerala,57 - Total Cognizable SLL crimes,2014,158558,398,158956,178847,436,179283,95401,176,95577,12275,10,12285,445081,1020,446101
Madhya Pradesh,"1 - Arms Act, 1959",2014,6860,0,6860,4245,1,4246,1344,0,1344,51,0,51,12500,1,12501
Madhya Pradesh,"2 - Narcotic Drugs & Psychotropic Substances Act, 1985",2014,448,13,461,320,21,341,176,14,190,13,0,13,957,48,1005
Madhya Pradesh,"3 - Gambling Act, 1867",2014,26945,6,26951,24787,14,24801,10702,2,10704,811,2,813,63245,24,63269
Madhya Pradesh,"4 - Excise Act, 1944",2014,22818,913,23731,20187,1514,21701,7530,748,8278,515,63,578,51050,3238,54288
Madhya Pradesh,5 - Prohibition Act,2014,18,0,18,7,0,7,6,0,6,0,0,0,31,0,31
Madhya Pradesh,6 - Explosives and Explosive Substances Act,2014,132,1,133,109,3,112,25,0,25,0,0,0,266,4,270
Madhya Pradesh,"7 - Immoral Traffic (Prevention) Act, 1956",2014,44,26,70,29,1,30,5,1,6,0,0,0,78,28,106
Madhya Pradesh,7.1 - Under Section 5,2014,6,7,13,1,0,1,0,0,0,0,0,0,7,7,14
Madhya Pradesh,7.2 - Under Section 6,2014,0,0,0,0,0,0,0,0,0,0,0,0,0,0,0
Madhya Pradesh,7.3 - Under Section 7,2014,11,8,19,1,0,1,0,1,1,0,0,0,12,9,21
Madhya Pradesh,7.4 - Under Section 8,2014,0,0,0,0,0,0,0,0,0,0,0,0,0,0,0
Madhya Pradesh,7.5 - Other Sections under ITP Act,2014,27,11,38,27,1,28,5,0,5,0,0,0,59,12,71
Madhya Pradesh,"8 - Indian Railways Act, 1989",2014,2,0,2,2,0,2,0,0,0,0,0,0,4,0,4
Madhya Pradesh,"9 - Registration of Foreigners Act, 1939",2014,0,0,0,0,0,0,0,0,0,0,0,0,0,0,0
Madhya Pradesh,"10 - Protection of Civil Rights Act, 1955",2014,0,0,0,0,0,0,0,0,0,0,0,0,0,0,0
Madhya Pradesh,10.1 - PCR Act for crimes committed against SCs,2014,0,0,0,0,0,0,0,0,0,0,0,0,0,0,0
Madhya Pradesh,10.2 - PCR Act for crimes committed against STs,2014,0,0,0,0,0,0,0,0,0,0,0,0,0,0,0
Madhya Pradesh,10.3 - PCR Act for crimes committed against Others,2014,0,0,0,0,0,0,0,0,0,0,0,0,0,0,0
Madhya Pradesh,"11 - Passport Act, 1967",2014,0,0,0,1,0,1,0,0,0,0,0,0,1,0,1
Madhya Pradesh,"12 - Essential Commodities Act, 1955",2014,106,4,110,145,1,146,38,0,38,6,0,6,295,5,300
Madhya Pradesh,"13 - Antiquities & Art Treasures Act, 1972",2014,0,0,0,0,0,0,0,0,0,0,0,0,0,0,0
Madhya Pradesh,"14 - Dowry Prohibition Act, 1961",2014,107,21,128,74,38,112,40,43,83,9,5,14,230,107,337
Madhya Pradesh,"15 - Indecent Representation of Women (Prohibition) Act, 1986",2014,0,0,0,0,0,0,0,0,0,0,0,0,0,0,0
Madhya Pradesh,"16 - Copyright Act, 1957",2014,42,0,42,55,0,55,13,0,13,0,0,0,110,0,110
Madhya Pradesh,17 - Commission of Sati Prevention Act 1987,2014,0,0,0,0,0,0,0,0,0,0,0,0,0,0,0
Madhya Pradesh,"18 - SC/ST (Prevention of Atrocities) Act, 1989)",2014,63,2,65,35,2,37,16,1,17,0,0,0,114,5,119
Madhya Pradesh,18.1 - POA Act for crimes committed against SCs,2014,49,2,51,22,0,22,14,1,15,0,0,0,85,3,88
Madhya Pradesh,18.2 - POA Act for crimes committed against STs,2014,14,0,14,13,2,15,2,0,2,0,0,0,29,2,31
Madhya Pradesh,"19 - Forest Act, 1927",2014,3,0,3,8,0,8,4,0,4,0,0,0,15,0,15
Madhya Pradesh,"20 - Prohibition of Child Marriage Act, 2006",2014,8,3,11,24,7,31,11,1,12,1,0,1,44,11,55
Madhya Pradesh,"21 - Protection of Women from Domestic Violence Act, 2005",2014,24,0,24,24,0,24,11,0,11,0,0,0,59,0,59
Madhya Pradesh,"22 - Information Technology Act, 2000",2014,105,5,110,45,3,48,3,0,3,0,0,0,153,8,161
Madhya Pradesh,"23 - Official Secrets Act, 1923",2014,0,0,0,0,0,0,0,0,0,0,0,0,0,0,0
Madhya Pradesh,"24 - Electricity Act, 2003",2014,74,0,74,86,0,86,11,0,11,1,0,1,172,0,172
Madhya Pradesh,"25 - Wildlife Protection Act, 1972",2014,12,0,12,22,0,22,8,0,8,0,0,0,42,0,42
Madhya Pradesh,"26 - Bonded Labour System (Abolition) Act, 1976",2014,0,0,0,0,0,0,0,0,0,0,0,0,0,0,0
Madhya Pradesh,26.1 - Against SCs,2014,0,0,0,0,0,0,0,0,0,0,0,0,0,0,0
Madhya Pradesh,26.2 - Against STs,2014,0,0,0,0,0,0,0,0,0,0,0,0,0,0,0
Madhya Pradesh,26.3 - Against others,2014,0,0,0,0,0,0,0,0,0,0,0,0,0,0,0
Madhya Pradesh,"27 - Environmental (Protection) Act, 1986",2014,0,0,0,0,0,0,0,0,0,0,0,0,0,0,0
Madhya Pradesh,"28 - Air (Prevention & Control of Pollution) Act, 1981",2014,0,0,0,0,0,0,0,0,0,0,0,0,0,0,0
Madhya Pradesh,"29 - Water (Prevention & Control of Pollution) Act, 1974(as amended in 1988)",2014,0,0,0,0,0,0,0,0,0,0,0,0,0,0,0
Madhya Pradesh,"30 - National Security Act, 1980",2014,55,0,55,52,0,52,5,0,5,0,0,0,112,0,112
Madhya Pradesh,"31 - Unlawful Activities (Prevention) Act, 1967",2014,0,0,0,0,0,0,0,0,0,0,0,0,0,0,0
Madhya Pradesh,"32 - Young Persons (Harmful Publications) Act, 1956",2014,0,0,0,0,0,0,0,0,0,0,0,0,0,0,0
Madhya Pradesh,"33 - Railway Property (Unlawful Possession) Act, 1966",2014,0,0,0,0,0,0,0,0,0,0,0,0,0,0,0
Madhya Pradesh,"34 - Prevention of Damage to Public Property Act, 1984",2014,2,0,2,10,0,10,3,0,3,0,0,0,15,0,15
Madhya Pradesh,"35 - Transplantation of Human Organs Act, 1994",2014,0,0,0,0,0,0,0,0,0,0,0,0,0,0,0
Madhya Pradesh,"36 - Trade Marks Act, 1999",2014,0,0,0,0,0,0,0,0,0,0,0,0,0,0,0
Madhya Pradesh,"37 - Prevention of Insults to National Honour Act, 1971",2014,0,0,0,9,1,10,1,0,1,0,0,0,10,1,11
Madhya Pradesh,"38 - State Emblem (Prohibition of Improper Use) Act, 2005",2014,0,0,0,0,0,0,0,0,0,0,0,0,0,0,0
Madhya Pradesh,"39 - Lotteries (Regulation) Act, 1998",2014,0,0,0,10,0,10,0,0,0,0,0,0,10,0,10
Madhya Pradesh,"40 - Citizenship Act, 1955",2014,0,0,0,0,0,0,0,0,0,0,0,0,0,0,0
Madhya Pradesh,"41 - Foreigners Act, 1946",2014,0,0,0,1,0,1,0,0,0,0,0,0,1,0,1
Madhya Pradesh,"42 - Place of Worship (Special Provisions) Act, 1991",2014,0,0,0,0,0,0,0,0,0,0,0,0,0,0,0
Madhya Pradesh,"43 - Religious Institution (Prevention of Misuse) Act, 1988",2014,0,0,0,0,0,0,0,0,0,0,0,0,0,0,0
Madhya Pradesh,"44 - Representation of People Act, 1951",2014,0,0,0,1,0,1,0,0,0,0,0,0,1,0,1
Madhya Pradesh,"45 - Emigration Act, 1983",2014,0,0,0,0,0,0,0,0,0,0,0,0,0,0,0
Madhya Pradesh,"46 - Juvenile Justice (Care and Protection of Children) Act, 2000",2014,2,0,2,0,0,0,0,0,0,0,0,0,2,0,2
Madhya Pradesh,"47 - Infant Substitutes Regulation Act, 2003",2014,0,0,0,0,0,0,0,0,0,0,0,0,0,0,0
Madhya Pradesh,"48 - Anti-Hijacking Act, 1982",2014,0,0,0,0,0,0,0,0,0,0,0,0,0,0,0
Madhya Pradesh,"49 - Atomic Energy Act, 1962",2014,0,0,0,0,0,0,0,0,0,0,0,0,0,0,0
Madhya Pradesh,"50 - Weapons of Mass Destruction (Proh. of Unlawful Activities) Act, 2005",2014,0,0,0,0,0,0,0,0,0,0,0,0,0,0,0
Madhya Pradesh,"51 - Suppression of Unlawful Acts against Safety of Civil Aviation Act, 1982",2014,0,0,0,0,0,0,0,0,0,0,0,0,0,0,0
Madhya Pradesh,"52 - Safety of Maritime Navigation Act, 2002",2014,0,0,0,0,0,0,0,0,0,0,0,0,0,0,0
Madhya Pradesh,"53 - Manual Scavengers and Construction of Dry Latrines (P) Act, 1993",2014,0,0,0,0,0,0,0,0,0,0,0,0,0,0,0
Madhya Pradesh,"54 - Pre-Natal Diagnostic Techniques (Reg and Prev of Misuse) Act, 1994",2014,0,0,0,0,0,0,0,0,0,0,0,0,0,0,0
Madhya Pradesh,"55 - The Maritime Zones of India (Reg of Fishing by Foreign Vessels) Act, 1981",2014,0,0,0,0,0,0,0,0,0,0,0,0,0,0,0
Madhya Pradesh,56 - Other SLL crimes,2014,7429,696,8125,5434,250,5684,3110,8,3118,68,0,68,16041,954,16995
Madhya Pradesh,57 - Total Cognizable SLL crimes,2014,65299,1690,66989,55722,1856,57578,23062,818,23880,1475,70,1545,145558,4434,149992
Maharashtra,"1 - Arms Act, 1959",2014,1211,1,1212,544,1,545,106,0,106,10,0,10,1871,2,1873
Maharashtra,"2 - Narcotic Drugs & Psychotropic Substances Act, 1985",2014,10468,14,10482,4674,33,4707,949,17,966,110,3,113,16201,67,16268
Maharashtra,"3 - Gambling Act, 1867",2014,17890,17,17907,17388,35,17423,7783,22,7805,1153,6,1159,44214,80,44294
Maharashtra,"4 - Excise Act, 1944",2014,0,0,0,0,0,0,0,0,0,0,0,0,0,0,0
Maharashtra,5 - Prohibition Act,2014,22148,1085,23233,25160,2424,27584,12075,1587,13662,1705,328,2033,61088,5424,66512
Maharashtra,6 - Explosives and Explosive Substances Act,2014,21,0,21,27,0,27,5,0,5,1,0,1,54,0,54
Maharashtra,"7 - Immoral Traffic (Prevention) Act, 1956",2014,208,80,288,188,91,279,48,13,61,4,1,5,448,185,633
Maharashtra,7.1 - Under Section 5,2014,62,26,88,86,34,120,20,3,23,3,0,3,171,63,234
Maharashtra,7.2 - Under Section 6,2014,14,2,16,2,1,3,1,0,1,0,0,0,17,3,20
Maharashtra,7.3 - Under Section 7,2014,26,7,33,27,15,42,1,7,8,0,0,0,54,29,83
Maharashtra,7.4 - Under Section 8,2014,4,20,24,2,21,23,0,1,1,0,1,1,6,43,49
Maharashtra,7.5 - Other Sections under ITP Act,2014,102,25,127,71,20,91,26,2,28,1,0,1,200,47,247
Maharashtra,"8 - Indian Railways Act, 1989",2014,4,0,4,1,0,1,0,0,0,0,0,0,5,0,5
Maharashtra,"9 - Registration of Foreigners Act, 1939",2014,5,1,6,3,0,3,0,1,1,0,0,0,8,2,10
Maharashtra,"10 - Protection of Civil Rights Act, 1955",2014,3,2,5,11,0,11,0,0,0,0,0,0,14,2,16
Maharashtra,10.1 - PCR Act for crimes committed against SCs,2014,2,2,4,11,0,11,0,0,0,0,0,0,13,2,15
Maharashtra,10.2 - PCR Act for crimes committed against STs,2014,1,0,1,0,0,0,0,0,0,0,0,0,1,0,1
Maharashtra,10.3 - PCR Act for crimes committed against Others,2014,0,0,0,0,0,0,0,0,0,0,0,0,0,0,0
Maharashtra,"11 - Passport Act, 1967",2014,84,23,107,43,13,56,4,0,4,2,0,2,133,36,169
Maharashtra,"12 - Essential Commodities Act, 1955",2014,539,2,541,754,17,771,253,7,260,35,2,37,1581,28,1609
Maharashtra,"13 - Antiquities & Art Treasures Act, 1972",2014,0,0,0,1,0,1,0,0,0,0,0,0,1,0,1
Maharashtra,"14 - Dowry Prohibition Act, 1961",2014,26,5,31,20,7,27,6,4,10,3,0,3,55,16,71
Maharashtra,"15 - Indecent Representation of Women (Prohibition) Act, 1986",2014,0,0,0,0,0,0,0,0,0,0,0,0,0,0,0
Maharashtra,"16 - Copyright Act, 1957",2014,210,0,210,198,4,202,38,0,38,2,0,2,448,4,452
Maharashtra,17 - Commission of Sati Prevention Act 1987,2014,0,0,0,0,0,0,0,0,0,0,0,0,0,0,0
Maharashtra,"18 - SC/ST (Prevention of Atrocities) Act, 1989)",2014,191,10,201,249,30,279,63,8,71,7,0,7,510,48,558
Maharashtra,18.1 - POA Act for crimes committed against SCs,2014,162,9,171,209,26,235,52,8,60,7,0,7,430,43,473
Maharashtra,18.2 - POA Act for crimes committed against STs,2014,29,1,30,40,4,44,11,0,11,0,0,0,80,5,85
Maharashtra,"19 - Forest Act, 1927",2014,12,0,12,26,0,26,1,0,1,0,0,0,39,0,39
Maharashtra,"20 - Prohibition of Child Marriage Act, 2006",2014,13,0,13,27,11,38,11,4,15,2,3,5,53,18,71
Maharashtra,"21 - Protection of Women from Domestic Violence Act, 2005",2014,0,0,0,3,1,4,2,0,2,0,0,0,5,1,6
Maharashtra,"22 - Information Technology Act, 2000",2014,132,2,134,86,3,89,5,2,7,0,0,0,223,7,230
Maharashtra,"23 - Official Secrets Act, 1923",2014,0,0,0,0,0,0,1,0,1,0,0,0,1,0,1
Maharashtra,"24 - Electricity Act, 2003",2014,219,8,227,253,16,269,56,6,62,10,1,11,538,31,569
Maharashtra,"25 - Wildlife Protection Act, 1972",2014,63,0,63,68,0,68,14,1,15,0,0,0,145,1,146
Maharashtra,"26 - Bonded Labour System (Abolition) Act, 1976",2014,28,0,28,2,0,2,0,0,0,0,0,0,30,0,30
Maharashtra,26.1 - Against SCs,2014,0,0,0,0,0,0,0,0,0,0,0,0,0,0,0
Maharashtra,26.2 - Against STs,2014,0,0,0,0,0,0,0,0,0,0,0,0,0,0,0
Maharashtra,26.3 - Against others,2014,28,0,28,2,0,2,0,0,0,0,0,0,30,0,30
Maharashtra,"27 - Environmental (Protection) Act, 1986",2014,10,0,10,20,0,20,8,0,8,0,0,0,38,0,38
Maharashtra,"28 - Air (Prevention & Control of Pollution) Act, 1981",2014,30,0,30,39,0,39,12,0,12,0,0,0,81,0,81
Maharashtra,"29 - Water (Prevention & Control of Pollution) Act, 1974(as amended in 1988)",2014,0,0,0,1,0,1,0,0,0,0,0,0,1,0,1
Maharashtra,"30 - National Security Act, 1980",2014,0,0,0,0,0,0,0,0,0,0,0,0,0,0,0
Maharashtra,"31 - Unlawful Activities (Prevention) Act, 1967",2014,0,0,0,0,0,0,0,0,0,0,0,0,0,0,0
Maharashtra,"32 - Young Persons (Harmful Publications) Act, 1956",2014,0,0,0,0,0,0,0,0,0,0,0,0,0,0,0
Maharashtra,"33 - Railway Property (Unlawful Possession) Act, 1966",2014,0,0,0,0,0,0,0,0,0,0,0,0,0,0,0
Maharashtra,"34 - Prevention of Damage to Public Property Act, 1984",2014,70,1,71,104,0,104,35,0,35,9,0,9,218,1,219
Maharashtra,"35 - Transplantation of Human Organs Act, 1994",2014,0,0,0,0,0,0,0,0,0,0,0,0,0,0,0
Maharashtra,"36 - Trade Marks Act, 1999",2014,1,0,1,1,0,1,0,0,0,0,0,0,2,0,2
Maharashtra,"37 - Prevention of Insults to National Honour Act, 1971",2014,1,0,1,12,2,14,4,0,4,0,0,0,17,2,19
Maharashtra,"38 - State Emblem (Prohibition of Improper Use) Act, 2005",2014,0,0,0,0,0,0,0,0,0,0,0,0,0,0,0
Maharashtra,"39 - Lotteries (Regulation) Act, 1998",2014,52,0,52,35,4,39,13,1,14,1,0,1,101,5,106
Maharashtra,"40 - Citizenship Act, 1955",2014,0,0,0,0,0,0,0,0,0,0,0,0,0,0,0
Maharashtra,"41 - Foreigners Act, 1946",2014,0,1,1,13,0,13,2,0,2,0,0,0,15,1,16
Maharashtra,"42 - Place of Worship (Special Provisions) Act, 1991",2014,0,0,0,0,0,0,0,0,0,0,0,0,0,0,0
Maharashtra,"43 - Religious Institution (Prevention of Misuse) Act, 1988",2014,0,0,0,1,0,1,0,0,0,0,0,0,1,0,1
Maharashtra,"44 - Representation of People Act, 1951",2014,30,1,31,43,0,43,29,0,29,9,0,9,111,1,112
Maharashtra,"45 - Emigration Act, 1983",2014,0,0,0,0,0,0,0,0,0,0,0,0,0,0,0
Maharashtra,"46 - Juvenile Justice (Care and Protection of Children) Act, 2000",2014,58,0,58,34,2,36,21,3,24,2,0,2,115,5,120
Maharashtra,"47 - Infant Substitutes Regulation Act, 2003",2014,0,0,0,0,0,0,0,0,0,0,0,0,0,0,0
Maharashtra,"48 - Anti-Hijacking Act, 1982",2014,0,0,0,0,0,0,0,0,0,0,0,0,0,0,0
Maharashtra,"49 - Atomic Energy Act, 1962",2014,1,0,1,0,0,0,0,0,0,0,0,0,1,0,1
Maharashtra,"50 - Weapons of Mass Destruction (Proh. of Unlawful Activities) Act, 2005",2014,0,0,0,0,0,0,0,0,0,0,0,0,0,0,0
Maharashtra,"51 - Suppression of Unlawful Acts against Safety of Civil Aviation Act, 1982",2014,0,0,0,0,0,0,0,0,0,0,0,0,0,0,0
Maharashtra,"52 - Safety of Maritime Navigation Act, 2002",2014,0,0,0,0,0,0,0,0,0,0,0,0,0,0,0
Maharashtra,"53 - Manual Scavengers and Construction of Dry Latrines (P) Act, 1993",2014,0,0,0,0,0,0,0,0,0,0,0,0,0,0,0
Maharashtra,"54 - Pre-Natal Diagnostic Techniques (Reg and Prev of Misuse) Act, 1994",2014,0,0,0,1,0,1,0,0,0,0,0,0,1,0,1
Maharashtra,"55 - The Maritime Zones of India (Reg of Fishing by Foreign Vessels) Act, 1981",2014,0,0,0,0,0,0,0,0,0,0,0,0,0,0,0
Maharashtra,56 - Other SLL crimes,2014,18152,452,18604,14680,583,15263,5565,224,5789,513,46,559,38910,1305,40215
Maharashtra,57 - Total Cognizable SLL crimes,2014,71880,1705,73585,64710,3277,67987,27109,1900,29009,3578,390,3968,167277,7272,174549
Manipur,"1 - Arms Act, 1959",2014,6,0,6,4,0,4,0,0,0,0,0,0,10,0,10
Manipur,"2 - Narcotic Drugs & Psychotropic Substances Act, 1985",2014,65,4,69,46,4,50,12,2,14,0,0,0,123,10,133
Manipur,"3 - Gambling Act, 1867",2014,1,0,1,1,0,1,4,0,4,0,0,0,6,0,6
Manipur,"4 - Excise Act, 1944",2014,0,0,0,0,0,0,0,0,0,0,0,0,0,0,0
Manipur,5 - Prohibition Act,2014,0,0,0,0,0,0,0,0,0,0,0,0,0,0,0
Manipur,6 - Explosives and Explosive Substances Act,2014,2,0,2,3,0,3,1,0,1,0,0,0,6,0,6
Manipur,"7 - Immoral Traffic (Prevention) Act, 1956",2014,0,0,0,0,0,0,0,0,0,0,0,0,0,0,0
Manipur,7.1 - Under Section 5,2014,0,0,0,0,0,0,0,0,0,0,0,0,0,0,0
Manipur,7.2 - Under Section 6,2014,0,0,0,0,0,0,0,0,0,0,0,0,0,0,0
Manipur,7.3 - Under Section 7,2014,0,0,0,0,0,0,0,0,0,0,0,0,0,0,0
Manipur,7.4 - Under Section 8,2014,0,0,0,0,0,0,0,0,0,0,0,0,0,0,0
Manipur,7.5 - Other Sections under ITP Act,2014,0,0,0,0,0,0,0,0,0,0,0,0,0,0,0
Manipur,"8 - Indian Railways Act, 1989",2014,0,0,0,0,0,0,0,0,0,0,0,0,0,0,0
Manipur,"9 - Registration of Foreigners Act, 1939",2014,5,0,5,2,0,2,0,0,0,0,0,0,7,0,7
Manipur,"10 - Protection of Civil Rights Act, 1955",2014,0,0,0,0,0,0,0,0,0,0,0,0,0,0,0
Manipur,10.1 - PCR Act for crimes committed against SCs,2014,0,0,0,0,0,0,0,0,0,0,0,0,0,0,0
Manipur,10.2 - PCR Act for crimes committed against STs,2014,0,0,0,0,0,0,0,0,0,0,0,0,0,0,0
Manipur,10.3 - PCR Act for crimes committed against Others,2014,0,0,0,0,0,0,0,0,0,0,0,0,0,0,0
Manipur,"11 - Passport Act, 1967",2014,0,0,0,0,0,0,0,0,0,0,0,0,0,0,0
Manipur,"12 - Essential Commodities Act, 1955",2014,0,0,0,0,0,0,0,0,0,0,0,0,0,0,0
Manipur,"13 - Antiquities & Art Treasures Act, 1972",2014,0,0,0,0,0,0,0,0,0,0,0,0,0,0,0
Manipur,"14 - Dowry Prohibition Act, 1961",2014,0,0,0,0,0,0,0,0,0,0,0,0,0,0,0
Manipur,"15 - Indecent Representation of Women (Prohibition) Act, 1986",2014,0,0,0,0,0,0,0,0,0,0,0,0,0,0,0
Manipur,"16 - Copyright Act, 1957",2014,0,0,0,0,0,0,0,0,0,0,0,0,0,0,0
Manipur,17 - Commission of Sati Prevention Act 1987,2014,0,0,0,0,0,0,0,0,0,0,0,0,0,0,0
Manipur,"18 - SC/ST (Prevention of Atrocities) Act, 1989)",2014,0,0,0,0,0,0,0,0,0,0,0,0,0,0,0
Manipur,18.1 - POA Act for crimes committed against SCs,2014,0,0,0,0,0,0,0,0,0,0,0,0,0,0,0
Manipur,18.2 - POA Act for crimes committed against STs,2014,0,0,0,0,0,0,0,0,0,0,0,0,0,0,0
Manipur,"19 - Forest Act, 1927",2014,0,0,0,0,0,0,0,0,0,0,0,0,0,0,0
Manipur,"20 - Prohibition of Child Marriage Act, 2006",2014,0,0,0,0,0,0,0,0,0,0,0,0,0,0,0
Manipur,"21 - Protection of Women from Domestic Violence Act, 2005",2014,0,0,0,0,0,0,0,0,0,0,0,0,0,0,0
Manipur,"22 - Information Technology Act, 2000",2014,1,0,1,0,0,0,0,0,0,0,0,0,1,0,1
Manipur,"23 - Official Secrets Act, 1923",2014,0,0,0,0,0,0,0,0,0,0,0,0,0,0,0
Manipur,"24 - Electricity Act, 2003",2014,2,0,2,3,0,3,0,0,0,0,0,0,5,0,5
Manipur,"25 - Wildlife Protection Act, 1972",2014,0,0,0,0,0,0,0,0,0,0,0,0,0,0,0
Manipur,"26 - Bonded Labour System (Abolition) Act, 1976",2014,0,0,0,0,0,0,0,0,0,0,0,0,0,0,0
Manipur,26.1 - Against SCs,2014,0,0,0,0,0,0,0,0,0,0,0,0,0,0,0
Manipur,26.2 - Against STs,2014,0,0,0,0,0,0,0,0,0,0,0,0,0,0,0
Manipur,26.3 - Against others,2014,0,0,0,0,0,0,0,0,0,0,0,0,0,0,0
Manipur,"27 - Environmental (Protection) Act, 1986",2014,0,0,0,0,0,0,0,0,0,0,0,0,0,0,0
Manipur,"28 - Air (Prevention & Control of Pollution) Act, 1981",2014,0,0,0,0,0,0,0,0,0,0,0,0,0,0,0
Manipur,"29 - Water (Prevention & Control of Pollution) Act, 1974(as amended in 1988)",2014,0,0,0,0,0,0,0,0,0,0,0,0,0,0,0
Manipur,"30 - National Security Act, 1980",2014,0,0,0,0,0,0,0,0,0,0,0,0,0,0,0
Manipur,"31 - Unlawful Activities (Prevention) Act, 1967",2014,298,19,317,384,29,413,95,10,105,8,1,9,785,59,844
Manipur,"32 - Young Persons (Harmful Publications) Act, 1956",2014,0,0,0,0,0,0,0,0,0,0,0,0,0,0,0
Manipur,"33 - Railway Property (Unlawful Possession) Act, 1966",2014,0,0,0,0,0,0,0,0,0,0,0,0,0,0,0
Manipur,"34 - Prevention of Damage to Public Property Act, 1984",2014,0,0,0,0,0,0,0,0,0,0,0,0,0,0,0
Manipur,"35 - Transplantation of Human Organs Act, 1994",2014,0,0,0,0,0,0,0,0,0,0,0,0,0,0,0
Manipur,"36 - Trade Marks Act, 1999",2014,0,0,0,0,0,0,0,0,0,0,0,0,0,0,0
Manipur,"37 - Prevention of Insults to National Honour Act, 1971",2014,0,0,0,0,0,0,0,0,0,0,0,0,0,0,0
Manipur,"38 - State Emblem (Prohibition of Improper Use) Act, 2005",2014,0,0,0,0,0,0,0,0,0,0,0,0,0,0,0
Manipur,"39 - Lotteries (Regulation) Act, 1998",2014,0,0,0,0,0,0,0,0,0,0,0,0,0,0,0
Manipur,"40 - Citizenship Act, 1955",2014,0,0,0,0,0,0,0,0,0,0,0,0,0,0,0
Manipur,"41 - Foreigners Act, 1946",2014,0,0,0,0,0,0,0,0,0,0,0,0,0,0,0
Manipur,"42 - Place of Worship (Special Provisions) Act, 1991",2014,0,0,0,0,0,0,0,0,0,0,0,0,0,0,0
Manipur,"43 - Religious Institution (Prevention of Misuse) Act, 1988",2014,0,0,0,0,0,0,0,0,0,0,0,0,0,0,0
Manipur,"44 - Representation of People Act, 1951",2014,0,0,0,0,0,0,0,0,0,0,0,0,0,0,0
Manipur,"45 - Emigration Act, 1983",2014,0,0,0,0,0,0,0,0,0,0,0,0,0,0,0
Manipur,"46 - Juvenile Justice (Care and Protection of Children) Act, 2000",2014,0,0,0,0,0,0,0,0,0,0,0,0,0,0,0
Manipur,"47 - Infant Substitutes Regulation Act, 2003",2014,0,0,0,0,0,0,0,0,0,0,0,0,0,0,0
Manipur,"48 - Anti-Hijacking Act, 1982",2014,0,0,0,0,0,0,0,0,0,0,0,0,0,0,0
Manipur,"49 - Atomic Energy Act, 1962",2014,0,0,0,0,0,0,0,0,0,0,0,0,0,0,0
Manipur,"50 - Weapons of Mass Destruction (Proh. of Unlawful Activities) Act, 2005",2014,0,0,0,0,0,0,0,0,0,0,0,0,0,0,0
Manipur,"51 - Suppression of Unlawful Acts against Safety of Civil Aviation Act, 1982",2014,0,0,0,0,0,0,0,0,0,0,0,0,0,0,0
Manipur,"52 - Safety of Maritime Navigation Act, 2002",2014,0,0,0,0,0,0,0,0,0,0,0,0,0,0,0
Manipur,"53 - Manual Scavengers and Construction of Dry Latrines (P) Act, 1993",2014,0,0,0,0,0,0,0,0,0,0,0,0,0,0,0
Manipur,"54 - Pre-Natal Diagnostic Techniques (Reg and Prev of Misuse) Act, 1994",2014,0,0,0,0,0,0,0,0,0,0,0,0,0,0,0
Manipur,"55 - The Maritime Zones of India (Reg of Fishing by Foreign Vessels) Act, 1981",2014,0,0,0,0,0,0,0,0,0,0,0,0,0,0,0
Manipur,56 - Other SLL crimes,2014,7,0,7,7,3,10,1,1,2,1,0,1,16,4,20
Manipur,57 - Total Cognizable SLL crimes,2014,387,23,410,450,36,486,113,13,126,9,1,10,959,73,1032
Meghalaya,"1 - Arms Act, 1959",2014,45,0,45,16,0,16,2,0,2,0,0,0,63,0,63
Meghalaya,"2 - Narcotic Drugs & Psychotropic Substances Act, 1985",2014,34,1,35,20,1,21,1,0,1,1,0,1,56,2,58
Meghalaya,"3 - Gambling Act, 1867",2014,10,0,10,18,0,18,0,0,0,0,0,0,28,0,28
Meghalaya,"4 - Excise Act, 1944",2014,3,2,5,2,4,6,0,0,0,0,0,0,5,6,11
Meghalaya,5 - Prohibition Act,2014,0,0,0,0,0,0,0,0,0,0,0,0,0,0,0
Meghalaya,6 - Explosives and Explosive Substances Act,2014,1,0,1,3,0,3,0,0,0,0,0,0,4,0,4
Meghalaya,"7 - Immoral Traffic (Prevention) Act, 1956",2014,3,2,5,0,1,1,0,0,0,0,0,0,3,3,6
Meghalaya,7.1 - Under Section 5,2014,3,2,5,0,1,1,0,0,0,0,0,0,3,3,6
Meghalaya,7.2 - Under Section 6,2014,0,0,0,0,0,0,0,0,0,0,0,0,0,0,0
Meghalaya,7.3 - Under Section 7,2014,0,0,0,0,0,0,0,0,0,0,0,0,0,0,0
Meghalaya,7.4 - Under Section 8,2014,0,0,0,0,0,0,0,0,0,0,0,0,0,0,0
Meghalaya,7.5 - Other Sections under ITP Act,2014,0,0,0,0,0,0,0,0,0,0,0,0,0,0,0
Meghalaya,"8 - Indian Railways Act, 1989",2014,0,0,0,0,0,0,0,0,0,0,0,0,0,0,0
Meghalaya,"9 - Registration of Foreigners Act, 1939",2014,0,0,0,0,0,0,0,0,0,0,0,0,0,0,0
Meghalaya,"10 - Protection of Civil Rights Act, 1955",2014,0,0,0,0,0,0,0,0,0,0,0,0,0,0,0
Meghalaya,10.1 - PCR Act for crimes committed against SCs,2014,0,0,0,0,0,0,0,0,0,0,0,0,0,0,0
Meghalaya,10.2 - PCR Act for crimes committed against STs,2014,0,0,0,0,0,0,0,0,0,0,0,0,0,0,0
Meghalaya,10.3 - PCR Act for crimes committed against Others,2014,0,0,0,0,0,0,0,0,0,0,0,0,0,0,0
Meghalaya,"11 - Passport Act, 1967",2014,1,0,1,2,0,2,0,0,0,0,0,0,3,0,3
Meghalaya,"12 - Essential Commodities Act, 1955",2014,1,0,1,4,0,4,0,0,0,0,0,0,5,0,5
Meghalaya,"13 - Antiquities & Art Treasures Act, 1972",2014,0,0,0,0,0,0,0,0,0,0,0,0,0,0,0
Meghalaya,"14 - Dowry Prohibition Act, 1961",2014,0,0,0,0,0,0,0,0,0,0,0,0,0,0,0
Meghalaya,"15 - Indecent Representation of Women (Prohibition) Act, 1986",2014,0,0,0,0,0,0,0,0,0,0,0,0,0,0,0
Meghalaya,"16 - Copyright Act, 1957",2014,1,0,1,1,0,1,0,0,0,0,0,0,2,0,2
Meghalaya,17 - Commission of Sati Prevention Act 1987,2014,0,0,0,0,0,0,0,0,0,0,0,0,0,0,0
Meghalaya,"18 - SC/ST (Prevention of Atrocities) Act, 1989)",2014,0,0,0,0,0,0,0,0,0,0,0,0,0,0,0
Meghalaya,18.1 - POA Act for crimes committed against SCs,2014,0,0,0,0,0,0,0,0,0,0,0,0,0,0,0
Meghalaya,18.2 - POA Act for crimes committed against STs,2014,0,0,0,0,0,0,0,0,0,0,0,0,0,0,0
Meghalaya,"19 - Forest Act, 1927",2014,0,0,0,0,0,0,0,0,0,0,0,0,0,0,0
Meghalaya,"20 - Prohibition of Child Marriage Act, 2006",2014,0,0,0,0,0,0,0,0,0,0,0,0,0,0,0
Meghalaya,"21 - Protection of Women from Domestic Violence Act, 2005",2014,0,0,0,0,0,0,0,0,0,0,0,0,0,0,0
Meghalaya,"22 - Information Technology Act, 2000",2014,6,1,7,0,0,0,0,0,0,0,0,0,6,1,7
Meghalaya,"23 - Official Secrets Act, 1923",2014,0,0,0,0,0,0,0,0,0,0,0,0,0,0,0
Meghalaya,"24 - Electricity Act, 2003",2014,0,0,0,0,0,0,0,0,0,0,0,0,0,0,0
Meghalaya,"25 - Wildlife Protection Act, 1972",2014,0,0,0,0,0,0,0,0,0,0,0,0,0,0,0
Meghalaya,"26 - Bonded Labour System (Abolition) Act, 1976",2014,0,0,0,0,0,0,0,0,0,0,0,0,0,0,0
Meghalaya,26.1 - Against SCs,2014,0,0,0,0,0,0,0,0,0,0,0,0,0,0,0
Meghalaya,26.2 - Against STs,2014,0,0,0,0,0,0,0,0,0,0,0,0,0,0,0
Meghalaya,26.3 - Against others,2014,0,0,0,0,0,0,0,0,0,0,0,0,0,0,0
Meghalaya,"27 - Environmental (Protection) Act, 1986",2014,0,0,0,0,0,0,0,0,0,0,0,0,0,0,0
Meghalaya,"28 - Air (Prevention & Control of Pollution) Act, 1981",2014,0,0,0,0,0,0,0,0,0,0,0,0,0,0,0
Meghalaya,"29 - Water (Prevention & Control of Pollution) Act, 1974(as amended in 1988)",2014,0,0,0,0,0,0,0,0,0,0,0,0,0,0,0
Meghalaya,"30 - National Security Act, 1980",2014,0,0,0,0,0,0,0,0,0,0,0,0,0,0,0
Meghalaya,"31 - Unlawful Activities (Prevention) Act, 1967",2014,6,0,6,0,0,0,0,0,0,0,0,0,6,0,6
Meghalaya,"32 - Young Persons (Harmful Publications) Act, 1956",2014,0,0,0,0,0,0,0,0,0,0,0,0,0,0,0
Meghalaya,"33 - Railway Property (Unlawful Possession) Act, 1966",2014,0,0,0,0,0,0,0,0,0,0,0,0,0,0,0
Meghalaya,"34 - Prevention of Damage to Public Property Act, 1984",2014,2,0,2,0,0,0,0,0,0,0,0,0,2,0,2
Meghalaya,"35 - Transplantation of Human Organs Act, 1994",2014,0,0,0,0,0,0,0,0,0,0,0,0,0,0,0
Meghalaya,"36 - Trade Marks Act, 1999",2014,0,0,0,0,0,0,0,0,0,0,0,0,0,0,0
Meghalaya,"37 - Prevention of Insults to National Honour Act, 1971",2014,0,0,0,0,0,0,0,0,0,0,0,0,0,0,0
Meghalaya,"38 - State Emblem (Prohibition of Improper Use) Act, 2005",2014,0,0,0,0,0,0,0,0,0,0,0,0,0,0,0
Meghalaya,"39 - Lotteries (Regulation) Act, 1998",2014,0,0,0,0,0,0,0,0,0,0,0,0,0,0,0
Meghalaya,"40 - Citizenship Act, 1955",2014,0,0,0,0,0,0,0,0,0,0,0,0,0,0,0
Meghalaya,"41 - Foreigners Act, 1946",2014,39,0,39,23,0,23,9,0,9,0,0,0,71,0,71
Meghalaya,"42 - Place of Worship (Special Provisions) Act, 1991",2014,0,0,0,0,0,0,0,0,0,0,0,0,0,0,0
Meghalaya,"43 - Religious Institution (Prevention of Misuse) Act, 1988",2014,0,0,0,0,0,0,0,0,0,0,0,0,0,0,0
Meghalaya,"44 - Representation of People Act, 1951",2014,0,0,0,0,0,0,0,0,0,0,0,0,0,0,0
Meghalaya,"45 - Emigration Act, 1983",2014,0,0,0,0,0,0,0,0,0,0,0,0,0,0,0
Meghalaya,"46 - Juvenile Justice (Care and Protection of Children) Act, 2000",2014,0,0,0,0,0,0,0,0,0,0,0,0,0,0,0
Meghalaya,"47 - Infant Substitutes Regulation Act, 2003",2014,0,0,0,0,0,0,0,0,0,0,0,0,0,0,0
Meghalaya,"48 - Anti-Hijacking Act, 1982",2014,0,0,0,0,0,0,0,0,0,0,0,0,0,0,0
Meghalaya,"49 - Atomic Energy Act, 1962",2014,0,0,0,0,0,0,0,0,0,0,0,0,0,0,0
Meghalaya,"50 - Weapons of Mass Destruction (Proh. of Unlawful Activities) Act, 2005",2014,0,0,0,0,0,0,0,0,0,0,0,0,0,0,0
Meghalaya,"51 - Suppression of Unlawful Acts against Safety of Civil Aviation Act, 1982",2014,0,0,0,0,0,0,0,0,0,0,0,0,0,0,0
Meghalaya,"52 - Safety of Maritime Navigation Act, 2002",2014,0,0,0,0,0,0,0,0,0,0,0,0,0,0,0
Meghalaya,"53 - Manual Scavengers and Construction of Dry Latrines (P) Act, 1993",2014,0,0,0,0,0,0,0,0,0,0,0,0,0,0,0
Meghalaya,"54 - Pre-Natal Diagnostic Techniques (Reg and Prev of Misuse) Act, 1994",2014,0,0,0,0,0,0,0,0,0,0,0,0,0,0,0
Meghalaya,"55 - The Maritime Zones of India (Reg of Fishing by Foreign Vessels) Act, 1981",2014,0,0,0,0,0,0,0,0,0,0,0,0,0,0,0
Meghalaya,56 - Other SLL crimes,2014,29,1,30,19,1,20,3,0,3,1,0,1,52,2,54
Meghalaya,57 - Total Cognizable SLL crimes,2014,181,7,188,108,7,115,15,0,15,2,0,2,306,14,320
Mizoram,"1 - Arms Act, 1959",2014,11,0,11,14,0,14,5,0,5,0,0,0,30,0,30
Mizoram,"2 - Narcotic Drugs & Psychotropic Substances Act, 1985",2014,67,15,82,40,9,49,12,1,13,0,0,0,119,25,144
Mizoram,"3 - Gambling Act, 1867",2014,0,0,0,0,0,0,0,0,0,0,0,0,0,0,0
Mizoram,"4 - Excise Act, 1944",2014,0,0,0,0,0,0,0,0,0,0,0,0,0,0,0
Mizoram,5 - Prohibition Act,2014,41,0,41,20,1,21,0,0,0,0,1,1,61,2,63
Mizoram,6 - Explosives and Explosive Substances Act,2014,9,1,10,5,1,6,0,0,0,0,0,0,14,2,16
Mizoram,"7 - Immoral Traffic (Prevention) Act, 1956",2014,0,0,0,0,0,0,0,0,0,0,0,0,0,0,0
Mizoram,7.1 - Under Section 5,2014,0,0,0,0,0,0,0,0,0,0,0,0,0,0,0
Mizoram,7.2 - Under Section 6,2014,0,0,0,0,0,0,0,0,0,0,0,0,0,0,0
Mizoram,7.3 - Under Section 7,2014,0,0,0,0,0,0,0,0,0,0,0,0,0,0,0
Mizoram,7.4 - Under Section 8,2014,0,0,0,0,0,0,0,0,0,0,0,0,0,0,0
Mizoram,7.5 - Other Sections under ITP Act,2014,0,0,0,0,0,0,0,0,0,0,0,0,0,0,0
Mizoram,"8 - Indian Railways Act, 1989",2014,0,0,0,0,0,0,0,0,0,0,0,0,0,0,0
Mizoram,"9 - Registration of Foreigners Act, 1939",2014,0,0,0,0,0,0,0,0,0,0,0,0,0,0,0
Mizoram,"10 - Protection of Civil Rights Act, 1955",2014,0,0,0,0,0,0,0,0,0,0,0,0,0,0,0
Mizoram,10.1 - PCR Act for crimes committed against SCs,2014,0,0,0,0,0,0,0,0,0,0,0,0,0,0,0
Mizoram,10.2 - PCR Act for crimes committed against STs,2014,0,0,0,0,0,0,0,0,0,0,0,0,0,0,0
Mizoram,10.3 - PCR Act for crimes committed against Others,2014,0,0,0,0,0,0,0,0,0,0,0,0,0,0,0
Mizoram,"11 - Passport Act, 1967",2014,11,0,11,5,0,5,3,0,3,0,0,0,19,0,19
Mizoram,"12 - Essential Commodities Act, 1955",2014,3,0,3,3,0,3,0,0,0,0,0,0,6,0,6
Mizoram,"13 - Antiquities & Art Treasures Act, 1972",2014,0,0,0,0,0,0,0,0,0,0,0,0,0,0,0
Mizoram,"14 - Dowry Prohibition Act, 1961",2014,0,0,0,0,0,0,0,0,0,0,0,0,0,0,0
Mizoram,"15 - Indecent Representation of Women (Prohibition) Act, 1986",2014,0,0,0,0,0,0,0,0,0,0,0,0,0,0,0
Mizoram,"16 - Copyright Act, 1957",2014,0,0,0,0,0,0,0,0,0,0,0,0,0,0,0
Mizoram,17 - Commission of Sati Prevention Act 1987,2014,0,0,0,0,0,0,0,0,0,0,0,0,0,0,0
Mizoram,"18 - SC/ST (Prevention of Atrocities) Act, 1989)",2014,0,0,0,0,0,0,0,0,0,0,0,0,0,0,0
Mizoram,18.1 - POA Act for crimes committed against SCs,2014,0,0,0,0,0,0,0,0,0,0,0,0,0,0,0
Mizoram,18.2 - POA Act for crimes committed against STs,2014,0,0,0,0,0,0,0,0,0,0,0,0,0,0,0
Mizoram,"19 - Forest Act, 1927",2014,0,0,0,0,0,0,0,0,0,0,0,0,0,0,0
Mizoram,"20 - Prohibition of Child Marriage Act, 2006",2014,0,0,0,0,0,0,0,0,0,0,0,0,0,0,0
Mizoram,"21 - Protection of Women from Domestic Violence Act, 2005",2014,0,0,0,0,0,0,0,0,0,0,0,0,0,0,0
Mizoram,"22 - Information Technology Act, 2000",2014,1,0,1,2,0,2,1,0,1,0,0,0,4,0,4
Mizoram,"23 - Official Secrets Act, 1923",2014,0,0,0,0,0,0,0,0,0,0,0,0,0,0,0
Mizoram,"24 - Electricity Act, 2003",2014,0,0,0,0,0,0,0,0,0,0,0,0,0,0,0
Mizoram,"25 - Wildlife Protection Act, 1972",2014,0,0,0,0,0,0,0,0,0,0,0,0,0,0,0
Mizoram,"26 - Bonded Labour System (Abolition) Act, 1976",2014,0,0,0,0,0,0,0,0,0,0,0,0,0,0,0
Mizoram,26.1 - Against SCs,2014,0,0,0,0,0,0,0,0,0,0,0,0,0,0,0
Mizoram,26.2 - Against STs,2014,0,0,0,0,0,0,0,0,0,0,0,0,0,0,0
Mizoram,26.3 - Against others,2014,0,0,0,0,0,0,0,0,0,0,0,0,0,0,0
Mizoram,"27 - Environmental (Protection) Act, 1986",2014,0,0,0,0,0,0,0,0,0,0,0,0,0,0,0
Mizoram,"28 - Air (Prevention & Control of Pollution) Act, 1981",2014,0,0,0,0,0,0,0,0,0,0,0,0,0,0,0
Mizoram,"29 - Water (Prevention & Control of Pollution) Act, 1974(as amended in 1988)",2014,0,0,0,0,0,0,0,0,0,0,0,0,0,0,0
Mizoram,"30 - National Security Act, 1980",2014,0,0,0,0,0,0,0,0,0,0,0,0,0,0,0
Mizoram,"31 - Unlawful Activities (Prevention) Act, 1967",2014,0,0,0,0,0,0,0,0,0,0,0,0,0,0,0
Mizoram,"32 - Young Persons (Harmful Publications) Act, 1956",2014,0,0,0,0,0,0,0,0,0,0,0,0,0,0,0
Mizoram,"33 - Railway Property (Unlawful Possession) Act, 1966",2014,0,0,0,0,0,0,0,0,0,0,0,0,0,0,0
Mizoram,"34 - Prevention of Damage to Public Property Act, 1984",2014,0,0,0,0,0,0,0,0,0,0,0,0,0,0,0
Mizoram,"35 - Transplantation of Human Organs Act, 1994",2014,0,0,0,0,0,0,0,0,0,0,0,0,0,0,0
Mizoram,"36 - Trade Marks Act, 1999",2014,0,0,0,0,0,0,0,0,0,0,0,0,0,0,0
Mizoram,"37 - Prevention of Insults to National Honour Act, 1971",2014,0,0,0,0,0,0,0,0,0,0,0,0,0,0,0
Mizoram,"38 - State Emblem (Prohibition of Improper Use) Act, 2005",2014,0,0,0,0,0,0,0,0,0,0,0,0,0,0,0
Mizoram,"39 - Lotteries (Regulation) Act, 1998",2014,0,0,0,0,0,0,0,0,0,0,0,0,0,0,0
Mizoram,"40 - Citizenship Act, 1955",2014,0,0,0,0,0,0,0,0,0,0,0,0,0,0,0
Mizoram,"41 - Foreigners Act, 1946",2014,0,0,0,4,0,4,1,0,1,0,0,0,5,0,5
Mizoram,"42 - Place of Worship (Special Provisions) Act, 1991",2014,0,0,0,0,0,0,0,0,0,0,0,0,0,0,0
Mizoram,"43 - Religious Institution (Prevention of Misuse) Act, 1988",2014,0,0,0,0,0,0,0,0,0,0,0,0,0,0,0
Mizoram,"44 - Representation of People Act, 1951",2014,0,0,0,0,0,0,0,0,0,0,0,0,0,0,0
Mizoram,"45 - Emigration Act, 1983",2014,0,0,0,0,0,0,0,0,0,0,0,0,0,0,0
Mizoram,"46 - Juvenile Justice (Care and Protection of Children) Act, 2000",2014,0,0,0,0,0,0,0,0,0,0,0,0,0,0,0
Mizoram,"47 - Infant Substitutes Regulation Act, 2003",2014,0,0,0,0,0,0,0,0,0,0,0,0,0,0,0
Mizoram,"48 - Anti-Hijacking Act, 1982",2014,0,0,0,0,0,0,0,0,0,0,0,0,0,0,0
Mizoram,"49 - Atomic Energy Act, 1962",2014,0,0,0,0,0,0,0,0,0,0,0,0,0,0,0
Mizoram,"50 - Weapons of Mass Destruction (Proh. of Unlawful Activities) Act, 2005",2014,0,0,0,0,0,0,0,0,0,0,0,0,0,0,0
Mizoram,"51 - Suppression of Unlawful Acts against Safety of Civil Aviation Act, 1982",2014,0,0,0,0,0,0,0,0,0,0,0,0,0,0,0
Mizoram,"52 - Safety of Maritime Navigation Act, 2002",2014,0,0,0,0,0,0,0,0,0,0,0,0,0,0,0
Mizoram,"53 - Manual Scavengers and Construction of Dry Latrines (P) Act, 1993",2014,0,0,0,0,0,0,0,0,0,0,0,0,0,0,0
Mizoram,"54 - Pre-Natal Diagnostic Techniques (Reg and Prev of Misuse) Act, 1994",2014,0,0,0,0,0,0,0,0,0,0,0,0,0,0,0
Mizoram,"55 - The Maritime Zones of India (Reg of Fishing by Foreign Vessels) Act, 1981",2014,0,0,0,0,0,0,0,0,0,0,0,0,0,0,0
Mizoram,56 - Other SLL crimes,2014,88,29,117,108,24,132,49,9,58,10,3,13,255,65,320
Mizoram,57 - Total Cognizable SLL crimes,2014,231,45,276,201,35,236,71,10,81,10,4,14,513,94,607
Nagaland,"1 - Arms Act, 1959",2014,115,1,116,121,2,123,8,0,8,3,0,3,247,3,250
Nagaland,"2 - Narcotic Drugs & Psychotropic Substances Act, 1985",2014,28,5,33,34,5,39,3,0,3,0,0,0,65,10,75
Nagaland,"3 - Gambling Act, 1867",2014,4,0,4,4,0,4,0,0,0,0,0,0,8,0,8
Nagaland,"4 - Excise Act, 1944",2014,16,0,16,15,2,17,1,0,1,0,1,1,32,3,35
Nagaland,5 - Prohibition Act,2014,47,1,48,33,2,35,1,0,1,0,0,0,81,3,84
Nagaland,6 - Explosives and Explosive Substances Act,2014,0,0,0,6,0,6,0,0,0,0,0,0,6,0,6
Nagaland,"7 - Immoral Traffic (Prevention) Act, 1956",2014,0,0,0,1,0,1,0,0,0,0,0,0,1,0,1
Nagaland,7.1 - Under Section 5,2014,0,0,0,1,0,1,0,0,0,0,0,0,1,0,1
Nagaland,7.2 - Under Section 6,2014,0,0,0,0,0,0,0,0,0,0,0,0,0,0,0
Nagaland,7.3 - Under Section 7,2014,0,0,0,0,0,0,0,0,0,0,0,0,0,0,0
Nagaland,7.4 - Under Section 8,2014,0,0,0,0,0,0,0,0,0,0,0,0,0,0,0
Nagaland,7.5 - Other Sections under ITP Act,2014,0,0,0,0,0,0,0,0,0,0,0,0,0,0,0
Nagaland,"8 - Indian Railways Act, 1989",2014,0,0,0,0,0,0,0,0,0,0,0,0,0,0,0
Nagaland,"9 - Registration of Foreigners Act, 1939",2014,0,0,0,0,0,0,0,0,0,0,0,0,0,0,0
Nagaland,"10 - Protection of Civil Rights Act, 1955",2014,0,0,0,0,0,0,0,0,0,0,0,0,0,0,0
Nagaland,10.1 - PCR Act for crimes committed against SCs,2014,0,0,0,0,0,0,0,0,0,0,0,0,0,0,0
Nagaland,10.2 - PCR Act for crimes committed against STs,2014,0,0,0,0,0,0,0,0,0,0,0,0,0,0,0
Nagaland,10.3 - PCR Act for crimes committed against Others,2014,0,0,0,0,0,0,0,0,0,0,0,0,0,0,0
Nagaland,"11 - Passport Act, 1967",2014,0,0,0,0,0,0,0,0,0,0,0,0,0,0,0
Nagaland,"12 - Essential Commodities Act, 1955",2014,0,0,0,1,0,1,0,0,0,0,0,0,1,0,1
Nagaland,"13 - Antiquities & Art Treasures Act, 1972",2014,0,0,0,0,0,0,0,0,0,0,0,0,0,0,0
Nagaland,"14 - Dowry Prohibition Act, 1961",2014,0,0,0,0,0,0,0,0,0,0,0,0,0,0,0
Nagaland,"15 - Indecent Representation of Women (Prohibition) Act, 1986",2014,0,0,0,0,0,0,0,0,0,0,0,0,0,0,0
Nagaland,"16 - Copyright Act, 1957",2014,0,0,0,0,0,0,0,0,0,0,0,0,0,0,0
Nagaland,17 - Commission of Sati Prevention Act 1987,2014,0,0,0,0,0,0,0,0,0,0,0,0,0,0,0
Nagaland,"18 - SC/ST (Prevention of Atrocities) Act, 1989)",2014,0,0,0,0,0,0,0,0,0,0,0,0,0,0,0
Nagaland,18.1 - POA Act for crimes committed against SCs,2014,0,0,0,0,0,0,0,0,0,0,0,0,0,0,0
Nagaland,18.2 - POA Act for crimes committed against STs,2014,0,0,0,0,0,0,0,0,0,0,0,0,0,0,0
Nagaland,"19 - Forest Act, 1927",2014,0,0,0,0,0,0,0,0,0,0,0,0,0,0,0
Nagaland,"20 - Prohibition of Child Marriage Act, 2006",2014,0,0,0,0,0,0,0,0,0,0,0,0,0,0,0
Nagaland,"21 - Protection of Women from Domestic Violence Act, 2005",2014,0,0,0,0,0,0,0,0,0,0,0,0,0,0,0
Nagaland,"22 - Information Technology Act, 2000",2014,0,0,0,0,0,0,0,0,0,0,0,0,0,0,0
Nagaland,"23 - Official Secrets Act, 1923",2014,0,0,0,0,0,0,0,0,0,0,0,0,0,0,0
Nagaland,"24 - Electricity Act, 2003",2014,0,0,0,0,0,0,0,0,0,0,0,0,0,0,0
Nagaland,"25 - Wildlife Protection Act, 1972",2014,0,0,0,0,0,0,0,0,0,0,0,0,0,0,0
Nagaland,"26 - Bonded Labour System (Abolition) Act, 1976",2014,0,0,0,0,0,0,0,0,0,0,0,0,0,0,0
Nagaland,26.1 - Against SCs,2014,0,0,0,0,0,0,0,0,0,0,0,0,0,0,0
Nagaland,26.2 - Against STs,2014,0,0,0,0,0,0,0,0,0,0,0,0,0,0,0
Nagaland,26.3 - Against others,2014,0,0,0,0,0,0,0,0,0,0,0,0,0,0,0
Nagaland,"27 - Environmental (Protection) Act, 1986",2014,0,0,0,0,0,0,0,0,0,0,0,0,0,0,0
Nagaland,"28 - Air (Prevention & Control of Pollution) Act, 1981",2014,0,0,0,0,0,0,0,0,0,0,0,0,0,0,0
Nagaland,"29 - Water (Prevention & Control of Pollution) Act, 1974(as amended in 1988)",2014,0,0,0,0,0,0,0,0,0,0,0,0,0,0,0
Nagaland,"30 - National Security Act, 1980",2014,2,0,2,0,0,0,1,0,1,0,0,0,3,0,3
Nagaland,"31 - Unlawful Activities (Prevention) Act, 1967",2014,0,0,0,0,0,0,0,0,0,0,0,0,0,0,0
Nagaland,"32 - Young Persons (Harmful Publications) Act, 1956",2014,0,0,0,0,0,0,0,0,0,0,0,0,0,0,0
Nagaland,"33 - Railway Property (Unlawful Possession) Act, 1966",2014,0,0,0,0,0,0,0,0,0,0,0,0,0,0,0
Nagaland,"34 - Prevention of Damage to Public Property Act, 1984",2014,0,0,0,0,0,0,0,0,0,0,0,0,0,0,0
Nagaland,"35 - Transplantation of Human Organs Act, 1994",2014,0,0,0,0,0,0,0,0,0,0,0,0,0,0,0
Nagaland,"36 - Trade Marks Act, 1999",2014,0,0,0,0,0,0,0,0,0,0,0,0,0,0,0
Nagaland,"37 - Prevention of Insults to National Honour Act, 1971",2014,0,0,0,0,0,0,0,0,0,0,0,0,0,0,0
Nagaland,"38 - State Emblem (Prohibition of Improper Use) Act, 2005",2014,0,0,0,0,0,0,0,0,0,0,0,0,0,0,0
Nagaland,"39 - Lotteries (Regulation) Act, 1998",2014,0,0,0,0,0,0,0,0,0,0,0,0,0,0,0
Nagaland,"40 - Citizenship Act, 1955",2014,0,0,0,0,0,0,0,0,0,0,0,0,0,0,0
Nagaland,"41 - Foreigners Act, 1946",2014,0,0,0,0,0,0,0,0,0,0,0,0,0,0,0
Nagaland,"42 - Place of Worship (Special Provisions) Act, 1991",2014,0,0,0,0,0,0,0,0,0,0,0,0,0,0,0
Nagaland,"43 - Religious Institution (Prevention of Misuse) Act, 1988",2014,0,0,0,0,0,0,0,0,0,0,0,0,0,0,0
Nagaland,"44 - Representation of People Act, 1951",2014,0,0,0,0,0,0,0,0,0,0,0,0,0,0,0
Nagaland,"45 - Emigration Act, 1983",2014,0,0,0,0,0,0,0,0,0,0,0,0,0,0,0
Nagaland,"46 - Juvenile Justice (Care and Protection of Children) Act, 2000",2014,0,0,0,0,0,0,0,0,0,0,0,0,0,0,0
Nagaland,"47 - Infant Substitutes Regulation Act, 2003",2014,0,0,0,0,0,0,0,0,0,0,0,0,0,0,0
Nagaland,"48 - Anti-Hijacking Act, 1982",2014,0,0,0,0,0,0,0,0,0,0,0,0,0,0,0
Nagaland,"49 - Atomic Energy Act, 1962",2014,0,0,0,0,0,0,0,0,0,0,0,0,0,0,0
Nagaland,"50 - Weapons of Mass Destruction (Proh. of Unlawful Activities) Act, 2005",2014,0,0,0,0,0,0,0,0,0,0,0,0,0,0,0
Nagaland,"51 - Suppression of Unlawful Acts against Safety of Civil Aviation Act, 1982",2014,0,0,0,0,0,0,0,0,0,0,0,0,0,0,0
Nagaland,"52 - Safety of Maritime Navigation Act, 2002",2014,0,0,0,0,0,0,0,0,0,0,0,0,0,0,0
Nagaland,"53 - Manual Scavengers and Construction of Dry Latrines (P) Act, 1993",2014,0,0,0,0,0,0,0,0,0,0,0,0,0,0,0
Nagaland,"54 - Pre-Natal Diagnostic Techniques (Reg and Prev of Misuse) Act, 1994",2014,0,0,0,0,0,0,0,0,0,0,0,0,0,0,0
Nagaland,"55 - The Maritime Zones of India (Reg of Fishing by Foreign Vessels) Act, 1981",2014,0,0,0,0,0,0,0,0,0,0,0,0,0,0,0
Nagaland,56 - Other SLL crimes,2014,86,3,89,43,0,43,5,0,5,0,0,0,134,3,137
Nagaland,57 - Total Cognizable SLL crimes,2014,298,10,308,258,11,269,19,0,19,3,1,4,578,22,600
Odisha,"1 - Arms Act, 1959",2014,401,3,404,278,0,278,37,0,37,0,0,0,716,3,719
Odisha,"2 - Narcotic Drugs & Psychotropic Substances Act, 1985",2014,379,1,380,261,3,264,49,1,50,0,0,0,689,5,694
Odisha,"3 - Gambling Act, 1867",2014,1472,9,1481,1825,3,1828,1069,0,1069,10,0,10,4376,12,4388
Odisha,"4 - Excise Act, 1944",2014,4972,69,5041,6812,349,7161,3885,114,3999,205,7,212,15874,539,16413
Odisha,5 - Prohibition Act,2014,0,0,0,0,0,0,0,0,0,0,0,0,0,0,0
Odisha,6 - Explosives and Explosive Substances Act,2014,161,0,161,133,1,134,39,0,39,0,0,0,333,1,334
Odisha,"7 - Immoral Traffic (Prevention) Act, 1956",2014,21,4,25,27,9,36,0,0,0,0,0,0,48,13,61
Odisha,7.1 - Under Section 5,2014,9,4,13,6,2,8,0,0,0,0,0,0,15,6,21
Odisha,7.2 - Under Section 6,2014,0,0,0,3,0,3,0,0,0,0,0,0,3,0,3
Odisha,7.3 - Under Section 7,2014,0,0,0,5,7,12,0,0,0,0,0,0,5,7,12
Odisha,7.4 - Under Section 8,2014,0,0,0,0,0,0,0,0,0,0,0,0,0,0,0
Odisha,7.5 - Other Sections under ITP Act,2014,12,0,12,13,0,13,0,0,0,0,0,0,25,0,25
Odisha,"8 - Indian Railways Act, 1989",2014,0,0,0,3,0,3,1,0,1,0,0,0,4,0,4
Odisha,"9 - Registration of Foreigners Act, 1939",2014,0,0,0,0,0,0,0,0,0,0,0,0,0,0,0
Odisha,"10 - Protection of Civil Rights Act, 1955",2014,0,0,0,0,0,0,0,0,0,0,0,0,0,0,0
Odisha,10.1 - PCR Act for crimes committed against SCs,2014,0,0,0,0,0,0,0,0,0,0,0,0,0,0,0
Odisha,10.2 - PCR Act for crimes committed against STs,2014,0,0,0,0,0,0,0,0,0,0,0,0,0,0,0
Odisha,10.3 - PCR Act for crimes committed against Others,2014,0,0,0,0,0,0,0,0,0,0,0,0,0,0,0
Odisha,"11 - Passport Act, 1967",2014,0,0,0,0,0,0,0,0,0,0,0,0,0,0,0
Odisha,"12 - Essential Commodities Act, 1955",2014,49,0,49,90,0,90,34,0,34,0,0,0,173,0,173
Odisha,"13 - Antiquities & Art Treasures Act, 1972",2014,0,0,0,0,0,0,0,0,0,0,0,0,0,0,0
Odisha,"14 - Dowry Prohibition Act, 1961",2014,379,24,403,392,97,489,242,81,323,2,1,3,1015,203,1218
Odisha,"15 - Indecent Representation of Women (Prohibition) Act, 1986",2014,0,0,0,0,0,0,0,0,0,0,0,0,0,0,0
Odisha,"16 - Copyright Act, 1957",2014,1,0,1,3,0,3,1,0,1,0,0,0,5,0,5
Odisha,17 - Commission of Sati Prevention Act 1987,2014,0,0,0,0,0,0,0,0,0,0,0,0,0,0,0
Odisha,"18 - SC/ST (Prevention of Atrocities) Act, 1989)",2014,581,2,583,585,4,589,139,4,143,0,0,0,1305,10,1315
Odisha,18.1 - POA Act for crimes committed against SCs,2014,499,2,501,481,4,485,117,2,119,0,0,0,1097,8,1105
Odisha,18.2 - POA Act for crimes committed against STs,2014,82,0,82,104,0,104,22,2,24,0,0,0,208,2,210
Odisha,"19 - Forest Act, 1927",2014,1,0,1,0,0,0,0,0,0,0,0,0,1,0,1
Odisha,"20 - Prohibition of Child Marriage Act, 2006",2014,0,0,0,0,0,0,0,0,0,0,0,0,0,0,0
Odisha,"21 - Protection of Women from Domestic Violence Act, 2005",2014,0,0,0,0,0,0,0,0,0,0,0,0,0,0,0
Odisha,"22 - Information Technology Act, 2000",2014,1,1,2,6,0,6,0,0,0,0,0,0,7,1,8
Odisha,"23 - Official Secrets Act, 1923",2014,0,0,0,0,0,0,0,0,0,0,0,0,0,0,0
Odisha,"24 - Electricity Act, 2003",2014,114,0,114,148,4,152,58,3,61,0,0,0,320,7,327
Odisha,"25 - Wildlife Protection Act, 1972",2014,1,0,1,0,0,0,0,0,0,0,0,0,1,0,1
Odisha,"26 - Bonded Labour System (Abolition) Act, 1976",2014,0,0,0,0,0,0,0,0,0,0,0,0,0,0,0
Odisha,26.1 - Against SCs,2014,0,0,0,0,0,0,0,0,0,0,0,0,0,0,0
Odisha,26.2 - Against STs,2014,0,0,0,0,0,0,0,0,0,0,0,0,0,0,0
Odisha,26.3 - Against others,2014,0,0,0,0,0,0,0,0,0,0,0,0,0,0,0
Odisha,"27 - Environmental (Protection) Act, 1986",2014,0,0,0,0,0,0,0,0,0,0,0,0,0,0,0
Odisha,"28 - Air (Prevention & Control of Pollution) Act, 1981",2014,0,0,0,0,0,0,0,0,0,0,0,0,0,0,0
Odisha,"29 - Water (Prevention & Control of Pollution) Act, 1974(as amended in 1988)",2014,0,0,0,0,0,0,0,0,0,0,0,0,0,0,0
Odisha,"30 - National Security Act, 1980",2014,2,0,2,1,0,1,0,0,0,0,0,0,3,0,3
Odisha,"31 - Unlawful Activities (Prevention) Act, 1967",2014,0,0,0,0,0,0,0,0,0,0,0,0,0,0,0
Odisha,"32 - Young Persons (Harmful Publications) Act, 1956",2014,2,0,2,4,0,4,0,0,0,0,0,0,6,0,6
Odisha,"33 - Railway Property (Unlawful Possession) Act, 1966",2014,0,0,0,0,0,0,0,0,0,0,0,0,0,0,0
Odisha,"34 - Prevention of Damage to Public Property Act, 1984",2014,1,0,1,8,0,8,1,0,1,0,0,0,10,0,10
Odisha,"35 - Transplantation of Human Organs Act, 1994",2014,0,0,0,0,0,0,0,0,0,0,0,0,0,0,0
Odisha,"36 - Trade Marks Act, 1999",2014,0,0,0,0,0,0,0,0,0,0,0,0,0,0,0
Odisha,"37 - Prevention of Insults to National Honour Act, 1971",2014,3,0,3,0,0,0,0,0,0,0,0,0,3,0,3
Odisha,"38 - State Emblem (Prohibition of Improper Use) Act, 2005",2014,0,0,0,0,0,0,0,0,0,0,0,0,0,0,0
Odisha,"39 - Lotteries (Regulation) Act, 1998",2014,0,0,0,0,0,0,0,0,0,0,0,0,0,0,0
Odisha,"40 - Citizenship Act, 1955",2014,0,0,0,0,0,0,0,0,0,0,0,0,0,0,0
Odisha,"41 - Foreigners Act, 1946",2014,0,0,0,1,0,1,0,0,0,0,0,0,1,0,1
Odisha,"42 - Place of Worship (Special Provisions) Act, 1991",2014,0,0,0,0,0,0,0,0,0,0,0,0,0,0,0
Odisha,"43 - Religious Institution (Prevention of Misuse) Act, 1988",2014,0,0,0,0,0,0,0,0,0,0,0,0,0,0,0
Odisha,"44 - Representation of People Act, 1951",2014,8,0,8,16,0,16,0,0,0,0,0,0,24,0,24
Odisha,"45 - Emigration Act, 1983",2014,0,0,0,0,0,0,0,0,0,0,0,0,0,0,0
Odisha,"46 - Juvenile Justice (Care and Protection of Children) Act, 2000",2014,12,0,12,3,0,3,1,0,1,0,0,0,16,0,16
Odisha,"47 - Infant Substitutes Regulation Act, 2003",2014,0,0,0,0,0,0,0,0,0,0,0,0,0,0,0
Odisha,"48 - Anti-Hijacking Act, 1982",2014,0,0,0,0,0,0,0,0,0,0,0,0,0,0,0
Odisha,"49 - Atomic Energy Act, 1962",2014,0,0,0,0,0,0,0,0,0,0,0,0,0,0,0
Odisha,"50 - Weapons of Mass Destruction (Proh. of Unlawful Activities) Act, 2005",2014,0,0,0,0,0,0,0,0,0,0,0,0,0,0,0
Odisha,"51 - Suppression of Unlawful Acts against Safety of Civil Aviation Act, 1982",2014,0,0,0,0,0,0,0,0,0,0,0,0,0,0,0
Odisha,"52 - Safety of Maritime Navigation Act, 2002",2014,0,0,0,0,0,0,0,0,0,0,0,0,0,0,0
Odisha,"53 - Manual Scavengers and Construction of Dry Latrines (P) Act, 1993",2014,0,0,0,0,0,0,0,0,0,0,0,0,0,0,0
Odisha,"54 - Pre-Natal Diagnostic Techniques (Reg and Prev of Misuse) Act, 1994",2014,0,0,0,0,0,0,0,0,0,0,0,0,0,0,0
Odisha,"55 - The Maritime Zones of India (Reg of Fishing by Foreign Vessels) Act, 1981",2014,0,0,0,0,0,0,0,0,0,0,0,0,0,0,0
Odisha,56 - Other SLL crimes,2014,412,17,429,263,10,273,152,3,155,0,0,0,827,30,857
Odisha,57 - Total Cognizable SLL crimes,2014,8973,130,9103,10859,480,11339,5708,206,5914,217,8,225,25757,824,26581
Punjab,"1 - Arms Act, 1959",2014,233,0,233,260,2,262,72,0,72,5,0,5,570,2,572
Punjab,"2 - Narcotic Drugs & Psychotropic Substances Act, 1985",2014,7086,211,7297,6729,390,7119,2456,181,2637,14,1,15,16285,783,17068
Punjab,"3 - Gambling Act, 1867",2014,1458,0,1458,1734,11,1745,363,1,364,0,0,0,3555,12,3567
Punjab,"4 - Excise Act, 1944",2014,3042,68,3110,3896,156,4052,1377,29,1406,24,0,24,8339,253,8592
Punjab,5 - Prohibition Act,2014,0,0,0,1,0,1,1,0,1,0,0,0,2,0,2
Punjab,6 - Explosives and Explosive Substances Act,2014,12,0,12,2,0,2,0,0,0,0,0,0,14,0,14
Punjab,"7 - Immoral Traffic (Prevention) Act, 1956",2014,113,86,199,74,66,140,8,4,12,0,0,0,195,156,351
Punjab,7.1 - Under Section 5,2014,64,43,107,43,39,82,5,2,7,0,0,0,112,84,196
Punjab,7.2 - Under Section 6,2014,0,0,0,0,0,0,0,0,0,0,0,0,0,0,0
Punjab,7.3 - Under Section 7,2014,0,0,0,0,0,0,0,0,0,0,0,0,0,0,0
Punjab,7.4 - Under Section 8,2014,2,1,3,0,0,0,0,0,0,0,0,0,2,1,3
Punjab,7.5 - Other Sections under ITP Act,2014,47,42,89,31,27,58,3,2,5,0,0,0,81,71,152
Punjab,"8 - Indian Railways Act, 1989",2014,0,0,0,1,0,1,0,0,0,0,0,0,1,0,1
Punjab,"9 - Registration of Foreigners Act, 1939",2014,0,0,0,0,0,0,0,0,0,0,0,0,0,0,0
Punjab,"10 - Protection of Civil Rights Act, 1955",2014,0,0,0,0,0,0,0,0,0,0,0,0,0,0,0
Punjab,10.1 - PCR Act for crimes committed against SCs,2014,0,0,0,0,0,0,0,0,0,0,0,0,0,0,0
Punjab,10.2 - PCR Act for crimes committed against STs,2014,0,0,0,0,0,0,0,0,0,0,0,0,0,0,0
Punjab,10.3 - PCR Act for crimes committed against Others,2014,0,0,0,0,0,0,0,0,0,0,0,0,0,0,0
Punjab,"11 - Passport Act, 1967",2014,3,0,3,8,0,8,1,1,2,1,0,1,13,1,14
Punjab,"12 - Essential Commodities Act, 1955",2014,30,0,30,69,0,69,14,0,14,0,0,0,113,0,113
Punjab,"13 - Antiquities & Art Treasures Act, 1972",2014,0,0,0,0,0,0,0,0,0,0,0,0,0,0,0
Punjab,"14 - Dowry Prohibition Act, 1961",2014,3,0,3,0,1,1,0,0,0,0,0,0,3,1,4
Punjab,"15 - Indecent Representation of Women (Prohibition) Act, 1986",2014,0,0,0,0,1,1,0,0,0,0,0,0,0,1,1
Punjab,"16 - Copyright Act, 1957",2014,91,1,92,146,0,146,36,0,36,0,0,0,273,1,274
Punjab,17 - Commission of Sati Prevention Act 1987,2014,0,0,0,0,0,0,0,0,0,0,0,0,0,0,0
Punjab,"18 - SC/ST (Prevention of Atrocities) Act, 1989)",2014,1,0,1,21,0,21,2,0,2,0,0,0,24,0,24
Punjab,18.1 - POA Act for crimes committed against SCs,2014,1,0,1,21,0,21,2,0,2,0,0,0,24,0,24
Punjab,18.2 - POA Act for crimes committed against STs,2014,0,0,0,0,0,0,0,0,0,0,0,0,0,0,0
Punjab,"19 - Forest Act, 1927",2014,2,0,2,0,0,0,0,0,0,0,0,0,2,0,2
Punjab,"20 - Prohibition of Child Marriage Act, 2006",2014,0,0,0,1,2,3,0,0,0,0,0,0,1,2,3
Punjab,"21 - Protection of Women from Domestic Violence Act, 2005",2014,1,0,1,0,1,1,0,0,0,0,0,0,1,1,2
Punjab,"22 - Information Technology Act, 2000",2014,74,3,77,46,7,53,1,0,1,0,0,0,121,10,131
Punjab,"23 - Official Secrets Act, 1923",2014,1,0,1,2,0,2,0,0,0,0,0,0,3,0,3
Punjab,"24 - Electricity Act, 2003",2014,0,0,0,0,0,0,0,0,0,0,0,0,0,0,0
Punjab,"25 - Wildlife Protection Act, 1972",2014,0,0,0,4,0,4,0,0,0,0,0,0,4,0,4
Punjab,"26 - Bonded Labour System (Abolition) Act, 1976",2014,7,0,7,4,0,4,0,0,0,0,0,0,11,0,11
Punjab,26.1 - Against SCs,2014,0,0,0,0,0,0,0,0,0,0,0,0,0,0,0
Punjab,26.2 - Against STs,2014,0,0,0,0,0,0,0,0,0,0,0,0,0,0,0
Punjab,26.3 - Against others,2014,7,0,7,4,0,4,0,0,0,0,0,0,11,0,11
Punjab,"27 - Environmental (Protection) Act, 1986",2014,0,0,0,0,0,0,0,0,0,0,0,0,0,0,0
Punjab,"28 - Air (Prevention & Control of Pollution) Act, 1981",2014,0,0,0,0,0,0,0,0,0,0,0,0,0,0,0
Punjab,"29 - Water (Prevention & Control of Pollution) Act, 1974(as amended in 1988)",2014,0,0,0,0,0,0,0,0,0,0,0,0,0,0,0
Punjab,"30 - National Security Act, 1980",2014,0,0,0,0,0,0,0,0,0,0,0,0,0,0,0
Punjab,"31 - Unlawful Activities (Prevention) Act, 1967",2014,1,0,1,5,0,5,0,0,0,0,0,0,6,0,6
Punjab,"32 - Young Persons (Harmful Publications) Act, 1956",2014,0,0,0,0,0,0,0,0,0,0,0,0,0,0,0
Punjab,"33 - Railway Property (Unlawful Possession) Act, 1966",2014,0,0,0,0,0,0,0,0,0,0,0,0,0,0,0
Punjab,"34 - Prevention of Damage to Public Property Act, 1984",2014,86,0,86,109,0,109,12,0,12,0,0,0,207,0,207
Punjab,"35 - Transplantation of Human Organs Act, 1994",2014,0,0,0,0,0,0,0,0,0,0,0,0,0,0,0
Punjab,"36 - Trade Marks Act, 1999",2014,0,0,0,3,0,3,0,0,0,0,0,0,3,0,3
Punjab,"37 - Prevention of Insults to National Honour Act, 1971",2014,0,0,0,0,0,0,0,0,0,0,0,0,0,0,0
Punjab,"38 - State Emblem (Prohibition of Improper Use) Act, 2005",2014,0,0,0,0,0,0,0,0,0,0,0,0,0,0,0
Punjab,"39 - Lotteries (Regulation) Act, 1998",2014,7,0,7,6,0,6,2,0,2,0,0,0,15,0,15
Punjab,"40 - Citizenship Act, 1955",2014,0,0,0,0,0,0,0,0,0,0,0,0,0,0,0
Punjab,"41 - Foreigners Act, 1946",2014,0,0,0,0,0,0,0,0,0,0,0,0,0,0,0
Punjab,"42 - Place of Worship (Special Provisions) Act, 1991",2014,1,0,1,0,0,0,0,0,0,0,0,0,1,0,1
Punjab,"43 - Religious Institution (Prevention of Misuse) Act, 1988",2014,0,0,0,0,0,0,1,0,1,0,0,0,1,0,1
Punjab,"44 - Representation of People Act, 1951",2014,3,0,3,4,0,4,0,0,0,0,0,0,7,0,7
Punjab,"45 - Emigration Act, 1983",2014,13,0,13,9,0,9,1,0,1,0,0,0,23,0,23
Punjab,"46 - Juvenile Justice (Care and Protection of Children) Act, 2000",2014,0,0,0,0,0,0,0,0,0,0,0,0,0,0,0
Punjab,"47 - Infant Substitutes Regulation Act, 2003",2014,0,0,0,0,0,0,0,0,0,0,0,0,0,0,0
Punjab,"48 - Anti-Hijacking Act, 1982",2014,0,0,0,0,0,0,0,0,0,0,0,0,0,0,0
Punjab,"49 - Atomic Energy Act, 1962",2014,0,0,0,0,0,0,0,0,0,0,0,0,0,0,0
Punjab,"50 - Weapons of Mass Destruction (Proh. of Unlawful Activities) Act, 2005",2014,0,0,0,0,0,0,0,0,0,0,0,0,0,0,0
Punjab,"51 - Suppression of Unlawful Acts against Safety of Civil Aviation Act, 1982",2014,0,0,0,0,0,0,0,0,0,0,0,0,0,0,0
Punjab,"52 - Safety of Maritime Navigation Act, 2002",2014,0,0,0,0,0,0,0,0,0,0,0,0,0,0,0
Punjab,"53 - Manual Scavengers and Construction of Dry Latrines (P) Act, 1993",2014,0,0,0,0,0,0,0,0,0,0,0,0,0,0,0
Punjab,"54 - Pre-Natal Diagnostic Techniques (Reg and Prev of Misuse) Act, 1994",2014,0,0,0,0,0,0,0,0,0,0,0,0,0,0,0
Punjab,"55 - The Maritime Zones of India (Reg of Fishing by Foreign Vessels) Act, 1981",2014,0,0,0,0,0,0,0,0,0,0,0,0,0,0,0
Punjab,56 - Other SLL crimes,2014,1223,14,1237,1465,27,1492,484,5,489,7,0,7,3179,46,3225
Punjab,57 - Total Cognizable SLL crimes,2014,13491,383,13874,14599,664,15263,4831,221,5052,51,1,52,32972,1269,34241
Rajasthan,"1 - Arms Act, 1959",2014,2963,0,2963,2003,0,2003,512,0,512,33,0,33,5511,0,5511
Rajasthan,"2 - Narcotic Drugs & Psychotropic Substances Act, 1985",2014,565,4,569,461,4,465,210,4,214,4,0,4,1240,12,1252
Rajasthan,"3 - Gambling Act, 1867",2014,13596,2,13598,12169,11,12180,5243,3,5246,432,0,432,31440,16,31456
Rajasthan,"4 - Excise Act, 1944",2014,5481,141,5622,4973,181,5154,2765,44,2809,147,2,149,13366,368,13734
Rajasthan,5 - Prohibition Act,2014,0,0,0,0,0,0,0,0,0,0,0,0,0,0,0
Rajasthan,6 - Explosives and Explosive Substances Act,2014,228,0,228,270,0,270,144,0,144,5,0,5,647,0,647
Rajasthan,"7 - Immoral Traffic (Prevention) Act, 1956",2014,162,161,323,62,46,108,13,7,20,3,0,3,240,214,454
Rajasthan,7.1 - Under Section 5,2014,29,32,61,12,12,24,0,1,1,1,0,1,42,45,87
Rajasthan,7.2 - Under Section 6,2014,24,4,28,7,3,10,1,0,1,1,0,1,33,7,40
Rajasthan,7.3 - Under Section 7,2014,0,0,0,0,0,0,1,0,1,0,0,0,1,0,1
Rajasthan,7.4 - Under Section 8,2014,3,1,4,0,0,0,0,0,0,0,0,0,3,1,4
Rajasthan,7.5 - Other Sections under ITP Act,2014,106,124,230,43,31,74,11,6,17,1,0,1,161,161,322
Rajasthan,"8 - Indian Railways Act, 1989",2014,1,0,1,1,0,1,0,0,0,0,0,0,2,0,2
Rajasthan,"9 - Registration of Foreigners Act, 1939",2014,1,0,1,1,0,1,0,0,0,0,0,0,2,0,2
Rajasthan,"10 - Protection of Civil Rights Act, 1955",2014,0,0,0,0,0,0,0,0,0,0,0,0,0,0,0
Rajasthan,10.1 - PCR Act for crimes committed against SCs,2014,0,0,0,0,0,0,0,0,0,0,0,0,0,0,0
Rajasthan,10.2 - PCR Act for crimes committed against STs,2014,0,0,0,0,0,0,0,0,0,0,0,0,0,0,0
Rajasthan,10.3 - PCR Act for crimes committed against Others,2014,0,0,0,0,0,0,0,0,0,0,0,0,0,0,0
Rajasthan,"11 - Passport Act, 1967",2014,0,0,0,2,0,2,0,0,0,0,0,0,2,0,2
Rajasthan,"12 - Essential Commodities Act, 1955",2014,70,0,70,136,1,137,35,0,35,1,0,1,242,1,243
Rajasthan,"13 - Antiquities & Art Treasures Act, 1972",2014,0,0,0,0,0,0,0,0,0,0,0,0,0,0,0
Rajasthan,"14 - Dowry Prohibition Act, 1961",2014,2,0,2,2,0,2,1,0,1,0,0,0,5,0,5
Rajasthan,"15 - Indecent Representation of Women (Prohibition) Act, 1986",2014,10,0,10,9,0,9,2,0,2,0,0,0,21,0,21
Rajasthan,"16 - Copyright Act, 1957",2014,133,0,133,134,1,135,19,0,19,1,0,1,287,1,288
Rajasthan,17 - Commission of Sati Prevention Act 1987,2014,0,0,0,0,0,0,0,0,0,0,0,0,0,0,0
Rajasthan,"18 - SC/ST (Prevention of Atrocities) Act, 1989)",2014,14,0,14,17,0,17,2,0,2,0,0,0,33,0,33
Rajasthan,18.1 - POA Act for crimes committed against SCs,2014,10,0,10,15,0,15,1,0,1,0,0,0,26,0,26
Rajasthan,18.2 - POA Act for crimes committed against STs,2014,4,0,4,2,0,2,1,0,1,0,0,0,7,0,7
Rajasthan,"19 - Forest Act, 1927",2014,1165,0,1165,1318,0,1318,406,0,406,24,0,24,2913,0,2913
Rajasthan,"20 - Prohibition of Child Marriage Act, 2006",2014,4,0,4,10,1,11,3,1,4,1,0,1,18,2,20
Rajasthan,"21 - Protection of Women from Domestic Violence Act, 2005",2014,2,0,2,7,1,8,5,1,6,0,0,0,14,2,16
Rajasthan,"22 - Information Technology Act, 2000",2014,100,1,101,54,0,54,24,1,25,0,0,0,178,2,180
Rajasthan,"23 - Official Secrets Act, 1923",2014,0,0,0,0,0,0,0,0,0,0,0,0,0,0,0
Rajasthan,"24 - Electricity Act, 2003",2014,443,0,443,516,0,516,64,0,64,0,0,0,1023,0,1023
Rajasthan,"25 - Wildlife Protection Act, 1972",2014,177,0,177,111,0,111,59,0,59,4,0,4,351,0,351
Rajasthan,"26 - Bonded Labour System (Abolition) Act, 1976",2014,1,0,1,4,0,4,0,0,0,0,0,0,5,0,5
Rajasthan,26.1 - Against SCs,2014,0,0,0,0,0,0,0,0,0,0,0,0,0,0,0
Rajasthan,26.2 - Against STs,2014,0,0,0,0,0,0,0,0,0,0,0,0,0,0,0
Rajasthan,26.3 - Against others,2014,1,0,1,4,0,4,0,0,0,0,0,0,5,0,5
Rajasthan,"27 - Environmental (Protection) Act, 1986",2014,12,0,12,23,1,24,12,0,12,0,0,0,47,1,48
Rajasthan,"28 - Air (Prevention & Control of Pollution) Act, 1981",2014,1,0,1,6,0,6,0,0,0,0,0,0,7,0,7
Rajasthan,"29 - Water (Prevention & Control of Pollution) Act, 1974(as amended in 1988)",2014,0,0,0,0,0,0,0,0,0,0,0,0,0,0,0
Rajasthan,"30 - National Security Act, 1980",2014,0,0,0,0,0,0,0,0,0,0,0,0,0,0,0
Rajasthan,"31 - Unlawful Activities (Prevention) Act, 1967",2014,0,0,0,0,0,0,0,0,0,0,0,0,0,0,0
Rajasthan,"32 - Young Persons (Harmful Publications) Act, 1956",2014,0,0,0,0,0,0,0,0,0,0,0,0,0,0,0
Rajasthan,"33 - Railway Property (Unlawful Possession) Act, 1966",2014,0,0,0,0,0,0,0,0,0,0,0,0,0,0,0
Rajasthan,"34 - Prevention of Damage to Public Property Act, 1984",2014,98,0,98,69,0,69,10,0,10,0,0,0,177,0,177
Rajasthan,"35 - Transplantation of Human Organs Act, 1994",2014,0,0,0,0,0,0,0,0,0,0,0,0,0,0,0
Rajasthan,"36 - Trade Marks Act, 1999",2014,3,0,3,3,0,3,0,0,0,0,0,0,6,0,6
Rajasthan,"37 - Prevention of Insults to National Honour Act, 1971",2014,0,0,0,0,0,0,0,0,0,0,0,0,0,0,0
Rajasthan,"38 - State Emblem (Prohibition of Improper Use) Act, 2005",2014,0,0,0,0,0,0,0,0,0,0,0,0,0,0,0
Rajasthan,"39 - Lotteries (Regulation) Act, 1998",2014,0,0,0,0,0,0,0,0,0,0,0,0,0,0,0
Rajasthan,"40 - Citizenship Act, 1955",2014,0,0,0,0,0,0,0,0,0,0,0,0,0,0,0
Rajasthan,"41 - Foreigners Act, 1946",2014,0,0,0,2,0,2,1,0,1,0,0,0,3,0,3
Rajasthan,"42 - Place of Worship (Special Provisions) Act, 1991",2014,0,0,0,0,0,0,0,0,0,0,0,0,0,0,0
Rajasthan,"43 - Religious Institution (Prevention of Misuse) Act, 1988",2014,0,0,0,0,0,0,0,0,0,0,0,0,0,0,0
Rajasthan,"44 - Representation of People Act, 1951",2014,0,0,0,0,0,0,0,0,0,0,0,0,0,0,0
Rajasthan,"45 - Emigration Act, 1983",2014,0,0,0,0,0,0,0,0,0,0,0,0,0,0,0
Rajasthan,"46 - Juvenile Justice (Care and Protection of Children) Act, 2000",2014,64,0,64,66,0,66,18,0,18,2,0,2,150,0,150
Rajasthan,"47 - Infant Substitutes Regulation Act, 2003",2014,0,0,0,0,0,0,0,0,0,0,0,0,0,0,0
Rajasthan,"48 - Anti-Hijacking Act, 1982",2014,0,0,0,0,0,0,0,0,0,0,0,0,0,0,0
Rajasthan,"49 - Atomic Energy Act, 1962",2014,0,0,0,0,0,0,0,0,0,0,0,0,0,0,0
Rajasthan,"50 - Weapons of Mass Destruction (Proh. of Unlawful Activities) Act, 2005",2014,0,0,0,0,0,0,0,0,0,0,0,0,0,0,0
Rajasthan,"51 - Suppression of Unlawful Acts against Safety of Civil Aviation Act, 1982",2014,0,0,0,0,0,0,0,0,0,0,0,0,0,0,0
Rajasthan,"52 - Safety of Maritime Navigation Act, 2002",2014,0,0,0,0,0,0,0,0,0,0,0,0,0,0,0
Rajasthan,"53 - Manual Scavengers and Construction of Dry Latrines (P) Act, 1993",2014,0,0,0,0,0,0,0,0,0,0,0,0,0,0,0
Rajasthan,"54 - Pre-Natal Diagnostic Techniques (Reg and Prev of Misuse) Act, 1994",2014,0,0,0,0,0,0,0,0,0,0,0,0,0,0,0
Rajasthan,"55 - The Maritime Zones of India (Reg of Fishing by Foreign Vessels) Act, 1981",2014,0,0,0,0,0,0,0,0,0,0,0,0,0,0,0
Rajasthan,56 - Other SLL crimes,2014,7413,32,7445,6093,37,6130,3252,12,3264,177,3,180,16935,84,17019
Rajasthan,57 - Total Cognizable SLL crimes,2014,32709,341,33050,28522,284,28806,12800,73,12873,834,5,839,74865,703,75568
Sikkim,"1 - Arms Act, 1959",2014,3,0,3,0,0,0,0,0,0,0,0,0,3,0,3
Sikkim,"2 - Narcotic Drugs & Psychotropic Substances Act, 1985",2014,2,0,2,1,0,1,0,0,0,0,0,0,3,0,3
Sikkim,"3 - Gambling Act, 1867",2014,0,0,0,0,0,0,0,0,0,0,0,0,0,0,0
Sikkim,"4 - Excise Act, 1944",2014,16,6,22,9,4,13,0,0,0,0,0,0,25,10,35
Sikkim,5 - Prohibition Act,2014,0,0,0,0,0,0,0,0,0,0,0,0,0,0,0
Sikkim,6 - Explosives and Explosive Substances Act,2014,0,0,0,0,0,0,0,0,0,0,0,0,0,0,0
Sikkim,"7 - Immoral Traffic (Prevention) Act, 1956",2014,1,0,1,3,1,4,0,0,0,1,0,1,5,1,6
Sikkim,7.1 - Under Section 5,2014,1,0,1,0,0,0,0,0,0,1,0,1,2,0,2
Sikkim,7.2 - Under Section 6,2014,0,0,0,0,0,0,0,0,0,0,0,0,0,0,0
Sikkim,7.3 - Under Section 7,2014,0,0,0,0,0,0,0,0,0,0,0,0,0,0,0
Sikkim,7.4 - Under Section 8,2014,0,0,0,0,0,0,0,0,0,0,0,0,0,0,0
Sikkim,7.5 - Other Sections under ITP Act,2014,0,0,0,3,1,4,0,0,0,0,0,0,3,1,4
Sikkim,"8 - Indian Railways Act, 1989",2014,0,0,0,0,0,0,0,0,0,0,0,0,0,0,0
Sikkim,"9 - Registration of Foreigners Act, 1939",2014,0,0,0,0,0,0,0,0,0,0,0,0,0,0,0
Sikkim,"10 - Protection of Civil Rights Act, 1955",2014,0,0,0,0,0,0,0,0,0,0,0,0,0,0,0
Sikkim,10.1 - PCR Act for crimes committed against SCs,2014,0,0,0,0,0,0,0,0,0,0,0,0,0,0,0
Sikkim,10.2 - PCR Act for crimes committed against STs,2014,0,0,0,0,0,0,0,0,0,0,0,0,0,0,0
Sikkim,10.3 - PCR Act for crimes committed against Others,2014,0,0,0,0,0,0,0,0,0,0,0,0,0,0,0
Sikkim,"11 - Passport Act, 1967",2014,0,0,0,0,0,0,0,0,0,0,0,0,0,0,0
Sikkim,"12 - Essential Commodities Act, 1955",2014,0,0,0,0,0,0,0,0,0,0,0,0,0,0,0
Sikkim,"13 - Antiquities & Art Treasures Act, 1972",2014,0,0,0,0,0,0,0,0,0,0,0,0,0,0,0
Sikkim,"14 - Dowry Prohibition Act, 1961",2014,0,0,0,0,0,0,0,0,0,0,0,0,0,0,0
Sikkim,"15 - Indecent Representation of Women (Prohibition) Act, 1986",2014,0,0,0,0,0,0,0,0,0,0,0,0,0,0,0
Sikkim,"16 - Copyright Act, 1957",2014,0,0,0,0,0,0,0,0,0,0,0,0,0,0,0
Sikkim,17 - Commission of Sati Prevention Act 1987,2014,0,0,0,0,0,0,0,0,0,0,0,0,0,0,0
Sikkim,"18 - SC/ST (Prevention of Atrocities) Act, 1989)",2014,0,0,0,2,0,2,0,0,0,0,0,0,2,0,2
Sikkim,18.1 - POA Act for crimes committed against SCs,2014,0,0,0,2,0,2,0,0,0,0,0,0,2,0,2
Sikkim,18.2 - POA Act for crimes committed against STs,2014,0,0,0,0,0,0,0,0,0,0,0,0,0,0,0
Sikkim,"19 - Forest Act, 1927",2014,0,0,0,0,0,0,0,0,0,0,0,0,0,0,0
Sikkim,"20 - Prohibition of Child Marriage Act, 2006",2014,0,0,0,0,0,0,0,0,0,0,0,0,0,0,0
Sikkim,"21 - Protection of Women from Domestic Violence Act, 2005",2014,0,0,0,0,0,0,0,0,0,0,0,0,0,0,0
Sikkim,"22 - Information Technology Act, 2000",2014,1,0,1,1,0,1,0,0,0,0,0,0,2,0,2
Sikkim,"23 - Official Secrets Act, 1923",2014,0,0,0,0,0,0,0,0,0,0,0,0,0,0,0
Sikkim,"24 - Electricity Act, 2003",2014,0,0,0,0,0,0,0,0,0,0,0,0,0,0,0
Sikkim,"25 - Wildlife Protection Act, 1972",2014,0,0,0,0,0,0,0,0,0,0,0,0,0,0,0
Sikkim,"26 - Bonded Labour System (Abolition) Act, 1976",2014,0,0,0,0,0,0,0,0,0,0,0,0,0,0,0
Sikkim,26.1 - Against SCs,2014,0,0,0,0,0,0,0,0,0,0,0,0,0,0,0
Sikkim,26.2 - Against STs,2014,0,0,0,0,0,0,0,0,0,0,0,0,0,0,0
Sikkim,26.3 - Against others,2014,0,0,0,0,0,0,0,0,0,0,0,0,0,0,0
Sikkim,"27 - Environmental (Protection) Act, 1986",2014,0,0,0,0,0,0,0,0,0,0,0,0,0,0,0
Sikkim,"28 - Air (Prevention & Control of Pollution) Act, 1981",2014,0,0,0,0,0,0,0,0,0,0,0,0,0,0,0
Sikkim,"29 - Water (Prevention & Control of Pollution) Act, 1974(as amended in 1988)",2014,0,0,0,0,0,0,0,0,0,0,0,0,0,0,0
Sikkim,"30 - National Security Act, 1980",2014,0,0,0,0,0,0,0,0,0,0,0,0,0,0,0
Sikkim,"31 - Unlawful Activities (Prevention) Act, 1967",2014,0,0,0,0,0,0,0,0,0,0,0,0,0,0,0
Sikkim,"32 - Young Persons (Harmful Publications) Act, 1956",2014,0,0,0,0,0,0,0,0,0,0,0,0,0,0,0
Sikkim,"33 - Railway Property (Unlawful Possession) Act, 1966",2014,0,0,0,0,0,0,0,0,0,0,0,0,0,0,0
Sikkim,"34 - Prevention of Damage to Public Property Act, 1984",2014,1,0,1,0,0,0,0,0,0,0,0,0,1,0,1
Sikkim,"35 - Transplantation of Human Organs Act, 1994",2014,0,0,0,0,0,0,0,0,0,0,0,0,0,0,0
Sikkim,"36 - Trade Marks Act, 1999",2014,0,0,0,0,0,0,0,0,0,0,0,0,0,0,0
Sikkim,"37 - Prevention of Insults to National Honour Act, 1971",2014,0,0,0,0,0,0,0,0,0,0,0,0,0,0,0
Sikkim,"38 - State Emblem (Prohibition of Improper Use) Act, 2005",2014,0,0,0,0,0,0,0,0,0,0,0,0,0,0,0
Sikkim,"39 - Lotteries (Regulation) Act, 1998",2014,0,0,0,0,0,0,0,0,0,0,0,0,0,0,0
Sikkim,"40 - Citizenship Act, 1955",2014,0,0,0,0,0,0,0,0,0,0,0,0,0,0,0
Sikkim,"41 - Foreigners Act, 1946",2014,2,0,2,4,0,4,1,0,1,0,0,0,7,0,7
Sikkim,"42 - Place of Worship (Special Provisions) Act, 1991",2014,0,0,0,0,0,0,0,0,0,0,0,0,0,0,0
Sikkim,"43 - Religious Institution (Prevention of Misuse) Act, 1988",2014,0,0,0,0,0,0,0,0,0,0,0,0,0,0,0
Sikkim,"44 - Representation of People Act, 1951",2014,0,0,0,0,0,0,0,0,0,0,0,0,0,0,0
Sikkim,"45 - Emigration Act, 1983",2014,0,0,0,0,0,0,0,0,0,0,0,0,0,0,0
Sikkim,"46 - Juvenile Justice (Care and Protection of Children) Act, 2000",2014,0,0,0,0,0,0,0,0,0,0,0,0,0,0,0
Sikkim,"47 - Infant Substitutes Regulation Act, 2003",2014,0,0,0,0,0,0,0,0,0,0,0,0,0,0,0
Sikkim,"48 - Anti-Hijacking Act, 1982",2014,0,0,0,0,0,0,0,0,0,0,0,0,0,0,0
Sikkim,"49 - Atomic Energy Act, 1962",2014,0,0,0,0,0,0,0,0,0,0,0,0,0,0,0
Sikkim,"50 - Weapons of Mass Destruction (Proh. of Unlawful Activities) Act, 2005",2014,0,0,0,0,0,0,0,0,0,0,0,0,0,0,0
Sikkim,"51 - Suppression of Unlawful Acts against Safety of Civil Aviation Act, 1982",2014,0,0,0,0,0,0,0,0,0,0,0,0,0,0,0
Sikkim,"52 - Safety of Maritime Navigation Act, 2002",2014,0,0,0,0,0,0,0,0,0,0,0,0,0,0,0
Sikkim,"53 - Manual Scavengers and Construction of Dry Latrines (P) Act, 1993",2014,0,0,0,0,0,0,0,0,0,0,0,0,0,0,0
Sikkim,"54 - Pre-Natal Diagnostic Techniques (Reg and Prev of Misuse) Act, 1994",2014,0,0,0,0,0,0,0,0,0,0,0,0,0,0,0
Sikkim,"55 - The Maritime Zones of India (Reg of Fishing by Foreign Vessels) Act, 1981",2014,0,0,0,0,0,0,0,0,0,0,0,0,0,0,0
Sikkim,56 - Other SLL crimes,2014,96,5,101,44,2,46,4,0,4,0,0,0,144,7,151
Sikkim,57 - Total Cognizable SLL crimes,2014,122,11,133,64,7,71,5,0,5,1,0,1,192,18,210
Tamil Nadu,"1 - Arms Act, 1959",2014,130,0,130,239,2,241,67,0,67,5,0,5,441,2,443
Tamil Nadu,"2 - Narcotic Drugs & Psychotropic Substances Act, 1985",2014,498,28,526,648,119,767,316,80,396,37,18,55,1499,245,1744
Tamil Nadu,"3 - Gambling Act, 1867",2014,4810,0,4810,8853,0,8853,4663,0,4663,286,0,286,18612,0,18612
Tamil Nadu,"4 - Excise Act, 1944",2014,0,0,0,0,0,0,0,0,0,0,0,0,0,0,0
Tamil Nadu,5 - Prohibition Act,2014,33123,2392,35515,46034,3620,49654,20442,1659,22101,1826,224,2050,101425,7895,109320
Tamil Nadu,6 - Explosives and Explosive Substances Act,2014,231,3,234,441,7,448,173,0,173,15,0,15,860,10,870
Tamil Nadu,"7 - Immoral Traffic (Prevention) Act, 1956",2014,212,111,323,299,137,436,131,44,175,1,0,1,643,292,935
Tamil Nadu,7.1 - Under Section 5,2014,44,33,77,66,37,103,28,21,49,1,0,1,139,91,230
Tamil Nadu,7.2 - Under Section 6,2014,2,0,2,0,2,2,3,0,3,0,0,0,5,2,7
Tamil Nadu,7.3 - Under Section 7,2014,0,0,0,0,0,0,0,0,0,0,0,0,0,0,0
Tamil Nadu,7.4 - Under Section 8,2014,1,7,8,8,11,19,0,0,0,0,0,0,9,18,27
Tamil Nadu,7.5 - Other Sections under ITP Act,2014,165,71,236,225,87,312,100,23,123,0,0,0,490,181,671
Tamil Nadu,"8 - Indian Railways Act, 1989",2014,6,0,6,5,0,5,0,0,0,0,0,0,11,0,11
Tamil Nadu,"9 - Registration of Foreigners Act, 1939",2014,2,0,2,11,0,11,0,0,0,0,0,0,13,0,13
Tamil Nadu,"10 - Protection of Civil Rights Act, 1955",2014,0,0,0,1,0,1,6,2,8,3,0,3,10,2,12
Tamil Nadu,10.1 - PCR Act for crimes committed against SCs,2014,0,0,0,0,0,0,6,2,8,3,0,3,9,2,11
Tamil Nadu,10.2 - PCR Act for crimes committed against STs,2014,0,0,0,0,0,0,0,0,0,0,0,0,0,0,0
Tamil Nadu,10.3 - PCR Act for crimes committed against Others,2014,0,0,0,1,0,1,0,0,0,0,0,0,1,0,1
Tamil Nadu,"11 - Passport Act, 1967",2014,149,4,153,252,26,278,34,0,34,0,0,0,435,30,465
Tamil Nadu,"12 - Essential Commodities Act, 1955",2014,3,0,3,17,0,17,3,0,3,0,0,0,23,0,23
Tamil Nadu,"13 - Antiquities & Art Treasures Act, 1972",2014,0,0,0,0,0,0,0,0,0,0,0,0,0,0,0
Tamil Nadu,"14 - Dowry Prohibition Act, 1961",2014,185,21,206,218,60,278,57,17,74,6,1,7,466,99,565
Tamil Nadu,"15 - Indecent Representation of Women (Prohibition) Act, 1986",2014,1,0,1,1,0,1,0,0,0,0,0,0,2,0,2
Tamil Nadu,"16 - Copyright Act, 1957",2014,1147,1,1148,1454,2,1456,259,0,259,2,0,2,2862,3,2865
Tamil Nadu,17 - Commission of Sati Prevention Act 1987,2014,0,0,0,0,0,0,0,0,0,0,0,0,0,0,0
Tamil Nadu,"18 - SC/ST (Prevention of Atrocities) Act, 1989)",2014,447,20,467,711,37,748,281,7,288,23,0,23,1462,64,1526
Tamil Nadu,18.1 - POA Act for crimes committed against SCs,2014,446,19,465,706,37,743,281,7,288,22,0,22,1455,63,1518
Tamil Nadu,18.2 - POA Act for crimes committed against STs,2014,1,1,2,5,0,5,0,0,0,1,0,1,7,1,8
Tamil Nadu,"19 - Forest Act, 1927",2014,28,0,28,22,0,22,2,0,2,0,0,0,52,0,52
Tamil Nadu,"20 - Prohibition of Child Marriage Act, 2006",2014,35,3,38,33,20,53,22,15,37,2,2,4,92,40,132
Tamil Nadu,"21 - Protection of Women from Domestic Violence Act, 2005",2014,1,0,1,3,0,3,0,0,0,0,0,0,4,0,4
Tamil Nadu,"22 - Information Technology Act, 2000",2014,54,0,54,41,1,42,1,0,1,1,0,1,97,1,98
Tamil Nadu,"23 - Official Secrets Act, 1923",2014,0,0,0,3,0,3,2,0,2,0,0,0,5,0,5
Tamil Nadu,"24 - Electricity Act, 2003",2014,3,0,3,6,0,6,1,0,1,0,0,0,10,0,10
Tamil Nadu,"25 - Wildlife Protection Act, 1972",2014,0,0,0,5,0,5,0,0,0,0,0,0,5,0,5
Tamil Nadu,"26 - Bonded Labour System (Abolition) Act, 1976",2014,1,0,1,5,0,5,6,0,6,0,0,0,12,0,12
Tamil Nadu,26.1 - Against SCs,2014,0,0,0,2,0,2,1,0,1,0,0,0,3,0,3
Tamil Nadu,26.2 - Against STs,2014,0,0,0,0,0,0,0,0,0,0,0,0,0,0,0
Tamil Nadu,26.3 - Against others,2014,1,0,1,3,0,3,5,0,5,0,0,0,9,0,9
Tamil Nadu,"27 - Environmental (Protection) Act, 1986",2014,0,0,0,0,0,0,0,0,0,0,0,0,0,0,0
Tamil Nadu,"28 - Air (Prevention & Control of Pollution) Act, 1981",2014,0,0,0,0,0,0,0,0,0,0,0,0,0,0,0
Tamil Nadu,"29 - Water (Prevention & Control of Pollution) Act, 1974(as amended in 1988)",2014,0,0,0,0,0,0,0,0,0,0,0,0,0,0,0
Tamil Nadu,"30 - National Security Act, 1980",2014,0,0,0,0,0,0,0,0,0,0,0,0,0,0,0
Tamil Nadu,"31 - Unlawful Activities (Prevention) Act, 1967",2014,0,0,0,0,0,0,0,0,0,0,0,0,0,0,0
Tamil Nadu,"32 - Young Persons (Harmful Publications) Act, 1956",2014,0,0,0,0,0,0,0,0,0,0,0,0,0,0,0
Tamil Nadu,"33 - Railway Property (Unlawful Possession) Act, 1966",2014,0,0,0,0,0,0,0,0,0,0,0,0,0,0,0
Tamil Nadu,"34 - Prevention of Damage to Public Property Act, 1984",2014,848,8,856,1006,17,1023,259,3,262,14,2,16,2127,30,2157
Tamil Nadu,"35 - Transplantation of Human Organs Act, 1994",2014,0,0,0,0,0,0,0,0,0,0,0,0,0,0,0
Tamil Nadu,"36 - Trade Marks Act, 1999",2014,0,0,0,4,0,4,0,0,0,0,0,0,4,0,4
Tamil Nadu,"37 - Prevention of Insults to National Honour Act, 1971",2014,1,0,1,0,0,0,0,0,0,0,0,0,1,0,1
Tamil Nadu,"38 - State Emblem (Prohibition of Improper Use) Act, 2005",2014,0,0,0,0,0,0,0,0,0,0,0,0,0,0,0
Tamil Nadu,"39 - Lotteries (Regulation) Act, 1998",2014,655,0,655,1061,3,1064,389,0,389,34,0,34,2139,3,2142
Tamil Nadu,"40 - Citizenship Act, 1955",2014,0,0,0,0,0,0,3,0,3,0,0,0,3,0,3
Tamil Nadu,"41 - Foreigners Act, 1946",2014,6,0,6,3,0,3,4,0,4,1,0,1,14,0,14
Tamil Nadu,"42 - Place of Worship (Special Provisions) Act, 1991",2014,0,0,0,0,0,0,0,0,0,0,0,0,0,0,0
Tamil Nadu,"43 - Religious Institution (Prevention of Misuse) Act, 1988",2014,0,0,0,0,0,0,0,0,0,0,0,0,0,0,0
Tamil Nadu,"44 - Representation of People Act, 1951",2014,0,0,0,0,0,0,0,0,0,0,0,0,0,0,0
Tamil Nadu,"45 - Emigration Act, 1983",2014,0,0,0,6,2,8,0,0,0,0,0,0,6,2,8
Tamil Nadu,"46 - Juvenile Justice (Care and Protection of Children) Act, 2000",2014,1,1,2,2,0,2,1,0,1,0,0,0,4,1,5
Tamil Nadu,"47 - Infant Substitutes Regulation Act, 2003",2014,0,0,0,0,0,0,0,0,0,0,0,0,0,0,0
Tamil Nadu,"48 - Anti-Hijacking Act, 1982",2014,0,0,0,0,0,0,0,0,0,0,0,0,0,0,0
Tamil Nadu,"49 - Atomic Energy Act, 1962",2014,0,0,0,0,0,0,0,0,0,0,0,0,0,0,0
Tamil Nadu,"50 - Weapons of Mass Destruction (Proh. of Unlawful Activities) Act, 2005",2014,0,0,0,0,0,0,0,0,0,0,0,0,0,0,0
Tamil Nadu,"51 - Suppression of Unlawful Acts against Safety of Civil Aviation Act, 1982",2014,0,0,0,0,0,0,0,0,0,0,0,0,0,0,0
Tamil Nadu,"52 - Safety of Maritime Navigation Act, 2002",2014,0,0,0,0,0,0,0,0,0,0,0,0,0,0,0
Tamil Nadu,"53 - Manual Scavengers and Construction of Dry Latrines (P) Act, 1993",2014,0,0,0,0,0,0,0,0,0,0,0,0,0,0,0
Tamil Nadu,"54 - Pre-Natal Diagnostic Techniques (Reg and Prev of Misuse) Act, 1994",2014,0,0,0,0,0,0,0,0,0,0,0,0,0,0,0
Tamil Nadu,"55 - The Maritime Zones of India (Reg of Fishing by Foreign Vessels) Act, 1981",2014,15,0,15,34,0,34,7,0,7,0,0,0,56,0,56
Tamil Nadu,56 - Other SLL crimes,2014,90542,5411,95953,71294,4836,76130,15932,1543,17475,704,86,790,178472,11876,190348
Tamil Nadu,57 - Total Cognizable SLL crimes,2014,133134,8003,141137,132712,8889,141601,43061,3370,46431,2960,333,3293,311867,20595,332462
Telangana,"1 - Arms Act, 1959",2014,56,0,56,142,0,142,27,0,27,0,0,0,225,0,225
Telangana,"2 - Narcotic Drugs & Psychotropic Substances Act, 1985",2014,100,4,104,197,11,208,64,0,64,15,3,18,376,18,394
Telangana,"3 - Gambling Act, 1867",2014,1494,0,1494,2129,4,2133,716,1,717,96,0,96,4435,5,4440
Telangana,"4 - Excise Act, 1944",2014,1701,123,1824,2360,322,2682,1202,195,1397,166,27,193,5429,667,6096
Telangana,5 - Prohibition Act,2014,1438,229,1667,2894,495,3389,1001,273,1274,91,74,165,5424,1071,6495
Telangana,6 - Explosives and Explosive Substances Act,2014,36,1,37,106,0,106,38,0,38,2,0,2,182,1,183
Telangana,"7 - Immoral Traffic (Prevention) Act, 1956",2014,371,103,474,328,105,433,81,33,114,5,0,5,785,241,1026
Telangana,7.1 - Under Section 5,2014,174,39,213,163,66,229,41,19,60,1,0,1,379,124,503
Telangana,7.2 - Under Section 6,2014,32,27,59,49,13,62,21,2,23,3,0,3,105,42,147
Telangana,7.3 - Under Section 7,2014,5,1,6,8,4,12,1,0,1,0,0,0,14,5,19
Telangana,7.4 - Under Section 8,2014,0,0,0,0,0,0,0,0,0,0,0,0,0,0,0
Telangana,7.5 - Other Sections under ITP Act,2014,160,36,196,108,22,130,18,12,30,1,0,1,287,70,357
Telangana,"8 - Indian Railways Act, 1989",2014,1,0,1,11,0,11,3,0,3,0,0,0,15,0,15
Telangana,"9 - Registration of Foreigners Act, 1939",2014,0,0,0,0,0,0,0,0,0,0,0,0,0,0,0
Telangana,"10 - Protection of Civil Rights Act, 1955",2014,0,0,0,10,0,10,0,0,0,0,0,0,10,0,10
Telangana,10.1 - PCR Act for crimes committed against SCs,2014,0,0,0,0,0,0,0,0,0,0,0,0,0,0,0
Telangana,10.2 - PCR Act for crimes committed against STs,2014,0,0,0,0,0,0,0,0,0,0,0,0,0,0,0
Telangana,10.3 - PCR Act for crimes committed against Others,2014,0,0,0,10,0,10,0,0,0,0,0,0,10,0,10
Telangana,"11 - Passport Act, 1967",2014,2,0,2,17,0,17,4,0,4,0,0,0,23,0,23
Telangana,"12 - Essential Commodities Act, 1955",2014,61,0,61,146,2,148,39,0,39,3,0,3,249,2,251
Telangana,"13 - Antiquities & Art Treasures Act, 1972",2014,4,0,4,15,0,15,20,0,20,1,0,1,40,0,40
Telangana,"14 - Dowry Prohibition Act, 1961",2014,171,4,175,455,35,490,150,44,194,31,4,35,807,87,894
Telangana,"15 - Indecent Representation of Women (Prohibition) Act, 1986",2014,0,0,0,4,0,4,0,0,0,0,0,0,4,0,4
Telangana,"16 - Copyright Act, 1957",2014,152,0,152,192,0,192,15,0,15,0,0,0,359,0,359
Telangana,17 - Commission of Sati Prevention Act 1987,2014,0,0,0,0,0,0,0,0,0,0,0,0,0,0,0
Telangana,"18 - SC/ST (Prevention of Atrocities) Act, 1989)",2014,271,4,275,422,4,426,292,1,293,108,0,108,1093,9,1102
Telangana,18.1 - POA Act for crimes committed against SCs,2014,209,4,213,314,4,318,219,1,220,61,0,61,803,9,812
Telangana,18.2 - POA Act for crimes committed against STs,2014,62,0,62,108,0,108,73,0,73,47,0,47,290,0,290
Telangana,"19 - Forest Act, 1927",2014,2,0,2,6,0,6,3,0,3,0,0,0,11,0,11
Telangana,"20 - Prohibition of Child Marriage Act, 2006",2014,5,0,5,20,8,28,7,1,8,1,0,1,33,9,42
Telangana,"21 - Protection of Women from Domestic Violence Act, 2005",2014,1,0,1,2,0,2,0,0,0,0,0,0,3,0,3
Telangana,"22 - Information Technology Act, 2000",2014,117,1,118,208,0,208,69,1,70,0,0,0,394,2,396
Telangana,"23 - Official Secrets Act, 1923",2014,0,0,0,0,0,0,0,0,0,0,0,0,0,0,0
Telangana,"24 - Electricity Act, 2003",2014,0,0,0,0,0,0,0,0,0,0,0,0,0,0,0
Telangana,"25 - Wildlife Protection Act, 1972",2014,0,0,0,0,0,0,0,0,0,0,0,0,0,0,0
Telangana,"26 - Bonded Labour System (Abolition) Act, 1976",2014,0,0,0,0,0,0,2,0,2,0,0,0,2,0,2
Telangana,26.1 - Against SCs,2014,0,0,0,0,0,0,0,0,0,0,0,0,0,0,0
Telangana,26.2 - Against STs,2014,0,0,0,0,0,0,0,0,0,0,0,0,0,0,0
Telangana,26.3 - Against others,2014,0,0,0,0,0,0,2,0,2,0,0,0,2,0,2
Telangana,"27 - Environmental (Protection) Act, 1986",2014,0,0,0,0,0,0,0,0,0,0,0,0,0,0,0
Telangana,"28 - Air (Prevention & Control of Pollution) Act, 1981",2014,0,0,0,0,0,0,0,0,0,0,0,0,0,0,0
Telangana,"29 - Water (Prevention & Control of Pollution) Act, 1974(as amended in 1988)",2014,9,0,9,12,0,12,3,0,3,0,0,0,24,0,24
Telangana,"30 - National Security Act, 1980",2014,0,0,0,0,0,0,0,0,0,0,0,0,0,0,0
Telangana,"31 - Unlawful Activities (Prevention) Act, 1967",2014,0,0,0,0,0,0,0,0,0,0,0,0,0,0,0
Telangana,"32 - Young Persons (Harmful Publications) Act, 1956",2014,0,0,0,0,0,0,0,0,0,0,0,0,0,0,0
Telangana,"33 - Railway Property (Unlawful Possession) Act, 1966",2014,0,0,0,0,0,0,0,0,0,0,0,0,0,0,0
Telangana,"34 - Prevention of Damage to Public Property Act, 1984",2014,7,0,7,8,1,9,1,0,1,0,0,0,16,1,17
Telangana,"35 - Transplantation of Human Organs Act, 1994",2014,0,0,0,0,0,0,0,0,0,0,0,0,0,0,0
Telangana,"36 - Trade Marks Act, 1999",2014,0,0,0,1,0,1,0,0,0,0,0,0,1,0,1
Telangana,"37 - Prevention of Insults to National Honour Act, 1971",2014,1,0,1,2,0,2,1,0,1,0,0,0,4,0,4
Telangana,"38 - State Emblem (Prohibition of Improper Use) Act, 2005",2014,0,0,0,1,0,1,0,0,0,0,0,0,1,0,1
Telangana,"39 - Lotteries (Regulation) Act, 1998",2014,0,0,0,0,0,0,0,0,0,0,0,0,0,0,0
Telangana,"40 - Citizenship Act, 1955",2014,0,0,0,0,0,0,0,0,0,0,0,0,0,0,0
Telangana,"41 - Foreigners Act, 1946",2014,2,0,2,7,0,7,1,0,1,0,0,0,10,0,10
Telangana,"42 - Place of Worship (Special Provisions) Act, 1991",2014,0,0,0,0,0,0,0,0,0,0,0,0,0,0,0
Telangana,"43 - Religious Institution (Prevention of Misuse) Act, 1988",2014,0,0,0,0,0,0,0,0,0,0,0,0,0,0,0
Telangana,"44 - Representation of People Act, 1951",2014,9,0,9,7,0,7,5,0,5,0,0,0,21,0,21
Telangana,"45 - Emigration Act, 1983",2014,1,0,1,2,0,2,3,0,3,0,0,0,6,0,6
Telangana,"46 - Juvenile Justice (Care and Protection of Children) Act, 2000",2014,45,0,45,5,4,9,1,1,2,0,0,0,51,5,56
Telangana,"47 - Infant Substitutes Regulation Act, 2003",2014,0,0,0,0,0,0,0,0,0,0,0,0,0,0,0
Telangana,"48 - Anti-Hijacking Act, 1982",2014,0,0,0,0,0,0,0,0,0,0,0,0,0,0,0
Telangana,"49 - Atomic Energy Act, 1962",2014,0,0,0,0,0,0,0,0,0,0,0,0,0,0,0
Telangana,"50 - Weapons of Mass Destruction (Proh. of Unlawful Activities) Act, 2005",2014,0,0,0,0,0,0,0,0,0,0,0,0,0,0,0
Telangana,"51 - Suppression of Unlawful Acts against Safety of Civil Aviation Act, 1982",2014,0,0,0,0,0,0,0,0,0,0,0,0,0,0,0
Telangana,"52 - Safety of Maritime Navigation Act, 2002",2014,0,0,0,0,0,0,0,0,0,0,0,0,0,0,0
Telangana,"53 - Manual Scavengers and Construction of Dry Latrines (P) Act, 1993",2014,0,0,0,0,0,0,0,0,0,0,0,0,0,0,0
Telangana,"54 - Pre-Natal Diagnostic Techniques (Reg and Prev of Misuse) Act, 1994",2014,0,0,0,1,0,1,0,0,0,0,0,0,1,0,1
Telangana,"55 - The Maritime Zones of India (Reg of Fishing by Foreign Vessels) Act, 1981",2014,0,0,0,0,0,0,0,0,0,0,0,0,0,0,0
Telangana,56 - Other SLL crimes,2014,1264,175,1439,2027,227,2254,777,115,892,86,18,104,4154,535,4689
Telangana,57 - Total Cognizable SLL crimes,2014,7321,644,7965,11737,1218,12955,4525,665,5190,605,126,731,24188,2653,26841
Tripura,"1 - Arms Act, 1959",2014,3,0,3,2,0,2,1,0,1,0,0,0,6,0,6
Tripura,"2 - Narcotic Drugs & Psychotropic Substances Act, 1985",2014,62,0,62,49,0,49,5,0,5,1,0,1,117,0,117
Tripura,"3 - Gambling Act, 1867",2014,4,0,4,2,0,2,0,0,0,0,0,0,6,0,6
Tripura,"4 - Excise Act, 1944",2014,0,0,0,0,0,0,0,0,0,0,0,0,0,0,0
Tripura,5 - Prohibition Act,2014,0,0,0,0,0,0,0,0,0,0,0,0,0,0,0
Tripura,6 - Explosives and Explosive Substances Act,2014,0,0,0,0,0,0,0,0,0,0,0,0,0,0,0
Tripura,"7 - Immoral Traffic (Prevention) Act, 1956",2014,0,0,0,0,0,0,0,0,0,0,0,0,0,0,0
Tripura,7.1 - Under Section 5,2014,0,0,0,0,0,0,0,0,0,0,0,0,0,0,0
Tripura,7.2 - Under Section 6,2014,0,0,0,0,0,0,0,0,0,0,0,0,0,0,0
Tripura,7.3 - Under Section 7,2014,0,0,0,0,0,0,0,0,0,0,0,0,0,0,0
Tripura,7.4 - Under Section 8,2014,0,0,0,0,0,0,0,0,0,0,0,0,0,0,0
Tripura,7.5 - Other Sections under ITP Act,2014,0,0,0,0,0,0,0,0,0,0,0,0,0,0,0
Tripura,"8 - Indian Railways Act, 1989",2014,0,0,0,0,0,0,0,0,0,0,0,0,0,0,0
Tripura,"9 - Registration of Foreigners Act, 1939",2014,0,0,0,0,0,0,0,0,0,0,0,0,0,0,0
Tripura,"10 - Protection of Civil Rights Act, 1955",2014,1,0,1,0,0,0,0,0,0,0,0,0,1,0,1
Tripura,10.1 - PCR Act for crimes committed against SCs,2014,0,0,0,0,0,0,0,0,0,0,0,0,0,0,0
Tripura,10.2 - PCR Act for crimes committed against STs,2014,0,0,0,0,0,0,0,0,0,0,0,0,0,0,0
Tripura,10.3 - PCR Act for crimes committed against Others,2014,1,0,1,0,0,0,0,0,0,0,0,0,1,0,1
Tripura,"11 - Passport Act, 1967",2014,44,1,45,15,1,16,6,0,6,0,1,1,65,3,68
Tripura,"12 - Essential Commodities Act, 1955",2014,28,1,29,20,1,21,5,0,5,0,0,0,53,2,55
Tripura,"13 - Antiquities & Art Treasures Act, 1972",2014,0,0,0,0,0,0,0,0,0,0,0,0,0,0,0
Tripura,"14 - Dowry Prohibition Act, 1961",2014,1,0,1,0,0,0,0,0,0,0,0,0,1,0,1
Tripura,"15 - Indecent Representation of Women (Prohibition) Act, 1986",2014,0,0,0,0,0,0,0,0,0,0,0,0,0,0,0
Tripura,"16 - Copyright Act, 1957",2014,0,0,0,0,0,0,0,0,0,0,0,0,0,0,0
Tripura,17 - Commission of Sati Prevention Act 1987,2014,0,0,0,0,0,0,0,0,0,0,0,0,0,0,0
Tripura,"18 - SC/ST (Prevention of Atrocities) Act, 1989)",2014,0,0,0,0,0,0,0,0,0,0,0,0,0,0,0
Tripura,18.1 - POA Act for crimes committed against SCs,2014,0,0,0,0,0,0,0,0,0,0,0,0,0,0,0
Tripura,18.2 - POA Act for crimes committed against STs,2014,0,0,0,0,0,0,0,0,0,0,0,0,0,0,0
Tripura,"19 - Forest Act, 1927",2014,0,0,0,0,0,0,0,0,0,0,0,0,0,0,0
Tripura,"20 - Prohibition of Child Marriage Act, 2006",2014,1,0,1,0,0,0,0,1,1,0,0,0,1,1,2
Tripura,"21 - Protection of Women from Domestic Violence Act, 2005",2014,0,0,0,0,0,0,0,0,0,0,0,0,0,0,0
Tripura,"22 - Information Technology Act, 2000",2014,1,0,1,0,0,0,0,0,0,0,0,0,1,0,1
Tripura,"23 - Official Secrets Act, 1923",2014,0,0,0,0,0,0,0,0,0,0,0,0,0,0,0
Tripura,"24 - Electricity Act, 2003",2014,0,0,0,0,0,0,0,0,0,0,0,0,0,0,0
Tripura,"25 - Wildlife Protection Act, 1972",2014,0,0,0,0,0,0,0,0,0,0,0,0,0,0,0
Tripura,"26 - Bonded Labour System (Abolition) Act, 1976",2014,0,0,0,0,0,0,0,0,0,0,0,0,0,0,0
Tripura,26.1 - Against SCs,2014,0,0,0,0,0,0,0,0,0,0,0,0,0,0,0
Tripura,26.2 - Against STs,2014,0,0,0,0,0,0,0,0,0,0,0,0,0,0,0
Tripura,26.3 - Against others,2014,0,0,0,0,0,0,0,0,0,0,0,0,0,0,0
Tripura,"27 - Environmental (Protection) Act, 1986",2014,0,0,0,0,0,0,0,0,0,0,0,0,0,0,0
Tripura,"28 - Air (Prevention & Control of Pollution) Act, 1981",2014,0,0,0,0,0,0,0,0,0,0,0,0,0,0,0
Tripura,"29 - Water (Prevention & Control of Pollution) Act, 1974(as amended in 1988)",2014,0,0,0,0,0,0,0,0,0,0,0,0,0,0,0
Tripura,"30 - National Security Act, 1980",2014,0,0,0,0,0,0,0,0,0,0,0,0,0,0,0
Tripura,"31 - Unlawful Activities (Prevention) Act, 1967",2014,0,0,0,0,0,0,0,0,0,0,0,0,0,0,0
Tripura,"32 - Young Persons (Harmful Publications) Act, 1956",2014,0,0,0,0,0,0,0,0,0,0,0,0,0,0,0
Tripura,"33 - Railway Property (Unlawful Possession) Act, 1966",2014,0,0,0,0,0,0,0,0,0,0,0,0,0,0,0
Tripura,"34 - Prevention of Damage to Public Property Act, 1984",2014,1,0,1,0,0,0,0,0,0,0,0,0,1,0,1
Tripura,"35 - Transplantation of Human Organs Act, 1994",2014,0,0,0,0,0,0,0,0,0,0,0,0,0,0,0
Tripura,"36 - Trade Marks Act, 1999",2014,0,0,0,0,0,0,0,0,0,0,0,0,0,0,0
Tripura,"37 - Prevention of Insults to National Honour Act, 1971",2014,0,0,0,0,0,0,0,1,1,0,0,0,0,1,1
Tripura,"38 - State Emblem (Prohibition of Improper Use) Act, 2005",2014,0,0,0,0,0,0,0,0,0,0,0,0,0,0,0
Tripura,"39 - Lotteries (Regulation) Act, 1998",2014,0,0,0,0,0,0,0,0,0,0,0,0,0,0,0
Tripura,"40 - Citizenship Act, 1955",2014,0,0,0,0,0,0,0,0,0,0,0,0,0,0,0
Tripura,"41 - Foreigners Act, 1946",2014,0,0,0,1,0,1,0,0,0,0,0,0,1,0,1
Tripura,"42 - Place of Worship (Special Provisions) Act, 1991",2014,0,0,0,0,0,0,0,0,0,0,0,0,0,0,0
Tripura,"43 - Religious Institution (Prevention of Misuse) Act, 1988",2014,0,0,0,0,0,0,0,0,0,0,0,0,0,0,0
Tripura,"44 - Representation of People Act, 1951",2014,0,0,0,0,0,0,0,0,0,0,0,0,0,0,0
Tripura,"45 - Emigration Act, 1983",2014,0,0,0,0,0,0,0,0,0,0,0,0,0,0,0
Tripura,"46 - Juvenile Justice (Care and Protection of Children) Act, 2000",2014,0,0,0,0,0,0,0,0,0,0,0,0,0,0,0
Tripura,"47 - Infant Substitutes Regulation Act, 2003",2014,0,0,0,0,0,0,0,0,0,0,0,0,0,0,0
Tripura,"48 - Anti-Hijacking Act, 1982",2014,0,0,0,0,0,0,0,0,0,0,0,0,0,0,0
Tripura,"49 - Atomic Energy Act, 1962",2014,0,0,0,0,0,0,0,0,0,0,0,0,0,0,0
Tripura,"50 - Weapons of Mass Destruction (Proh. of Unlawful Activities) Act, 2005",2014,0,0,0,0,0,0,0,0,0,0,0,0,0,0,0
Tripura,"51 - Suppression of Unlawful Acts against Safety of Civil Aviation Act, 1982",2014,0,0,0,0,0,0,0,0,0,0,0,0,0,0,0
Tripura,"52 - Safety of Maritime Navigation Act, 2002",2014,0,0,0,0,0,0,0,0,0,0,0,0,0,0,0
Tripura,"53 - Manual Scavengers and Construction of Dry Latrines (P) Act, 1993",2014,0,0,0,0,0,0,0,0,0,0,0,0,0,0,0
Tripura,"54 - Pre-Natal Diagnostic Techniques (Reg and Prev of Misuse) Act, 1994",2014,0,0,0,0,0,0,0,0,0,0,0,0,0,0,0
Tripura,"55 - The Maritime Zones of India (Reg of Fishing by Foreign Vessels) Act, 1981",2014,0,0,0,0,0,0,0,0,0,0,0,0,0,0,0
Tripura,56 - Other SLL crimes,2014,11,1,12,3,0,3,0,0,0,0,0,0,14,1,15
Tripura,57 - Total Cognizable SLL crimes,2014,157,3,160,92,2,94,17,2,19,1,1,2,267,8,275
Uttar Pradesh,"1 - Arms Act, 1959",2014,15597,0,15597,8185,0,8185,1462,1,1463,61,0,61,25305,1,25306
Uttar Pradesh,"2 - Narcotic Drugs & Psychotropic Substances Act, 1985",2014,3413,22,3435,2037,19,2056,431,2,433,12,0,12,5893,43,5936
Uttar Pradesh,"3 - Gambling Act, 1867",2014,14256,0,14256,9810,1,9811,2826,1,2827,141,0,141,27033,2,27035
Uttar Pradesh,"4 - Excise Act, 1944",2014,17884,296,18180,15560,605,16165,5087,265,5352,250,0,250,38781,1166,39947
Uttar Pradesh,5 - Prohibition Act,2014,0,0,0,0,0,0,0,0,0,0,0,0,0,0,0
Uttar Pradesh,6 - Explosives and Explosive Substances Act,2014,458,0,458,188,0,188,24,0,24,0,0,0,670,0,670
Uttar Pradesh,"7 - Immoral Traffic (Prevention) Act, 1956",2014,84,39,123,67,27,94,4,1,5,0,0,0,155,67,222
Uttar Pradesh,7.1 - Under Section 5,2014,69,19,88,45,15,60,2,1,3,0,0,0,116,35,151
Uttar Pradesh,7.2 - Under Section 6,2014,9,14,23,13,12,25,0,0,0,0,0,0,22,26,48
Uttar Pradesh,7.3 - Under Section 7,2014,0,0,0,0,0,0,0,0,0,0,0,0,0,0,0
Uttar Pradesh,7.4 - Under Section 8,2014,0,0,0,0,0,0,0,0,0,0,0,0,0,0,0
Uttar Pradesh,7.5 - Other Sections under ITP Act,2014,6,6,12,9,0,9,2,0,2,0,0,0,17,6,23
Uttar Pradesh,"8 - Indian Railways Act, 1989",2014,49,0,49,87,0,87,20,0,20,0,0,0,156,0,156
Uttar Pradesh,"9 - Registration of Foreigners Act, 1939",2014,0,0,0,0,0,0,0,0,0,0,0,0,0,0,0
Uttar Pradesh,"10 - Protection of Civil Rights Act, 1955",2014,0,0,0,0,0,0,0,0,0,0,0,0,0,0,0
Uttar Pradesh,10.1 - PCR Act for crimes committed against SCs,2014,0,0,0,0,0,0,0,0,0,0,0,0,0,0,0
Uttar Pradesh,10.2 - PCR Act for crimes committed against STs,2014,0,0,0,0,0,0,0,0,0,0,0,0,0,0,0
Uttar Pradesh,10.3 - PCR Act for crimes committed against Others,2014,0,0,0,0,0,0,0,0,0,0,0,0,0,0,0
Uttar Pradesh,"11 - Passport Act, 1967",2014,1,0,1,0,0,0,0,0,0,0,0,0,1,0,1
Uttar Pradesh,"12 - Essential Commodities Act, 1955",2014,544,0,544,773,1,774,274,0,274,9,0,9,1600,1,1601
Uttar Pradesh,"13 - Antiquities & Art Treasures Act, 1972",2014,0,0,0,0,0,0,0,0,0,0,0,0,0,0,0
Uttar Pradesh,"14 - Dowry Prohibition Act, 1961",2014,2133,537,2670,2702,857,3559,1666,461,2127,40,5,45,6541,1860,8401
Uttar Pradesh,"15 - Indecent Representation of Women (Prohibition) Act, 1986",2014,0,0,0,1,0,1,0,0,0,0,0,0,1,0,1
Uttar Pradesh,"16 - Copyright Act, 1957",2014,69,0,69,64,0,64,6,0,6,0,0,0,139,0,139
Uttar Pradesh,17 - Commission of Sati Prevention Act 1987,2014,0,0,0,0,0,0,0,0,0,0,0,0,0,0,0
Uttar Pradesh,"18 - SC/ST (Prevention of Atrocities) Act, 1989)",2014,3133,11,3144,1917,39,1956,751,25,776,3,0,3,5804,75,5879
Uttar Pradesh,18.1 - POA Act for crimes committed against SCs,2014,3127,11,3138,1895,39,1934,747,25,772,3,0,3,5772,75,5847
Uttar Pradesh,18.2 - POA Act for crimes committed against STs,2014,6,0,6,22,0,22,4,0,4,0,0,0,32,0,32
Uttar Pradesh,"19 - Forest Act, 1927",2014,921,0,921,1347,0,1347,607,0,607,13,0,13,2888,0,2888
Uttar Pradesh,"20 - Prohibition of Child Marriage Act, 2006",2014,3,0,3,21,4,25,5,0,5,0,0,0,29,4,33
Uttar Pradesh,"21 - Protection of Women from Domestic Violence Act, 2005",2014,99,21,120,110,25,135,63,13,76,14,0,14,286,59,345
Uttar Pradesh,"22 - Information Technology Act, 2000",2014,894,0,894,259,1,260,18,0,18,0,0,0,1171,1,1172
Uttar Pradesh,"23 - Official Secrets Act, 1923",2014,0,0,0,0,0,0,0,0,0,0,0,0,0,0,0
Uttar Pradesh,"24 - Electricity Act, 2003",2014,7534,31,7565,16576,47,16623,9223,38,9261,809,0,809,34142,116,34258
Uttar Pradesh,"25 - Wildlife Protection Act, 1972",2014,116,1,117,238,4,242,25,0,25,0,0,0,379,5,384
Uttar Pradesh,"26 - Bonded Labour System (Abolition) Act, 1976",2014,0,0,0,11,0,11,0,0,0,0,0,0,11,0,11
Uttar Pradesh,26.1 - Against SCs,2014,0,0,0,2,0,2,0,0,0,0,0,0,2,0,2
Uttar Pradesh,26.2 - Against STs,2014,0,0,0,0,0,0,0,0,0,0,0,0,0,0,0
Uttar Pradesh,26.3 - Against others,2014,0,0,0,9,0,9,0,0,0,0,0,0,9,0,9
Uttar Pradesh,"27 - Environmental (Protection) Act, 1986",2014,6,0,6,0,0,0,0,0,0,0,0,0,6,0,6
Uttar Pradesh,"28 - Air (Prevention & Control of Pollution) Act, 1981",2014,0,0,0,0,0,0,0,0,0,0,0,0,0,0,0
Uttar Pradesh,"29 - Water (Prevention & Control of Pollution) Act, 1974(as amended in 1988)",2014,0,0,0,0,0,0,0,0,0,0,0,0,0,0,0
Uttar Pradesh,"30 - National Security Act, 1980",2014,102,0,102,112,0,112,7,0,7,0,0,0,221,0,221
Uttar Pradesh,"31 - Unlawful Activities (Prevention) Act, 1967",2014,59,0,59,36,0,36,0,0,0,0,0,0,95,0,95
Uttar Pradesh,"32 - Young Persons (Harmful Publications) Act, 1956",2014,0,0,0,0,0,0,0,0,0,0,0,0,0,0,0
Uttar Pradesh,"33 - Railway Property (Unlawful Possession) Act, 1966",2014,0,0,0,0,0,0,0,0,0,0,0,0,0,0,0
Uttar Pradesh,"34 - Prevention of Damage to Public Property Act, 1984",2014,273,0,273,403,0,403,153,0,153,0,0,0,829,0,829
Uttar Pradesh,"35 - Transplantation of Human Organs Act, 1994",2014,0,0,0,0,0,0,0,0,0,0,0,0,0,0,0
Uttar Pradesh,"36 - Trade Marks Act, 1999",2014,0,0,0,14,0,14,0,0,0,0,0,0,14,0,14
Uttar Pradesh,"37 - Prevention of Insults to National Honour Act, 1971",2014,0,0,0,2,0,2,0,0,0,0,0,0,2,0,2
Uttar Pradesh,"38 - State Emblem (Prohibition of Improper Use) Act, 2005",2014,0,0,0,0,0,0,0,0,0,0,0,0,0,0,0
Uttar Pradesh,"39 - Lotteries (Regulation) Act, 1998",2014,0,0,0,0,0,0,0,0,0,0,0,0,0,0,0
Uttar Pradesh,"40 - Citizenship Act, 1955",2014,0,0,0,0,0,0,0,0,0,0,0,0,0,0,0
Uttar Pradesh,"41 - Foreigners Act, 1946",2014,1,0,1,6,0,6,0,0,0,0,0,0,7,0,7
Uttar Pradesh,"42 - Place of Worship (Special Provisions) Act, 1991",2014,5,0,5,2,0,2,0,0,0,0,0,0,7,0,7
Uttar Pradesh,"43 - Religious Institution (Prevention of Misuse) Act, 1988",2014,0,0,0,0,0,0,0,0,0,0,0,0,0,0,0
Uttar Pradesh,"44 - Representation of People Act, 1951",2014,14,0,14,31,0,31,12,0,12,0,0,0,57,0,57
Uttar Pradesh,"45 - Emigration Act, 1983",2014,0,0,0,0,0,0,0,0,0,0,0,0,0,0,0
Uttar Pradesh,"46 - Juvenile Justice (Care and Protection of Children) Act, 2000",2014,3,0,3,1,0,1,0,0,0,0,0,0,4,0,4
Uttar Pradesh,"47 - Infant Substitutes Regulation Act, 2003",2014,0,0,0,0,0,0,0,0,0,0,0,0,0,0,0
Uttar Pradesh,"48 - Anti-Hijacking Act, 1982",2014,0,0,0,0,0,0,0,0,0,0,0,0,0,0,0
Uttar Pradesh,"49 - Atomic Energy Act, 1962",2014,0,0,0,0,0,0,0,0,0,0,0,0,0,0,0
Uttar Pradesh,"50 - Weapons of Mass Destruction (Proh. of Unlawful Activities) Act, 2005",2014,0,0,0,0,0,0,0,0,0,0,0,0,0,0,0
Uttar Pradesh,"51 - Suppression of Unlawful Acts against Safety of Civil Aviation Act, 1982",2014,0,0,0,0,0,0,0,0,0,0,0,0,0,0,0
Uttar Pradesh,"52 - Safety of Maritime Navigation Act, 2002",2014,0,0,0,0,0,0,0,0,0,0,0,0,0,0,0
Uttar Pradesh,"53 - Manual Scavengers and Construction of Dry Latrines (P) Act, 1993",2014,0,0,0,0,0,0,0,0,0,0,0,0,0,0,0
Uttar Pradesh,"54 - Pre-Natal Diagnostic Techniques (Reg and Prev of Misuse) Act, 1994",2014,0,0,0,0,0,0,0,0,0,0,0,0,0,0,0
Uttar Pradesh,"55 - The Maritime Zones of India (Reg of Fishing by Foreign Vessels) Act, 1981",2014,0,0,0,0,0,0,0,0,0,0,0,0,0,0,0
Uttar Pradesh,56 - Other SLL crimes,2014,1475420,995,1476415,699303,413,699716,153626,163,153789,2259,0,2259,2330608,1571,2332179
Uttar Pradesh,57 - Total Cognizable SLL crimes,2014,1543071,1953,1545024,759863,2043,761906,176290,970,177260,3611,5,3616,2482835,4971,2487806
Uttarakhand,"1 - Arms Act, 1959",2014,466,1,467,259,0,259,36,0,36,0,0,0,761,1,762
Uttarakhand,"2 - Narcotic Drugs & Psychotropic Substances Act, 1985",2014,135,0,135,216,2,218,12,0,12,1,0,1,364,2,366
Uttarakhand,"3 - Gambling Act, 1867",2014,261,0,261,193,0,193,50,0,50,0,0,0,504,0,504
Uttarakhand,"4 - Excise Act, 1944",2014,976,36,1012,1078,31,1109,181,7,188,5,0,5,2240,74,2314
Uttarakhand,5 - Prohibition Act,2014,0,0,0,0,0,0,0,0,0,0,0,0,0,0,0
Uttarakhand,6 - Explosives and Explosive Substances Act,2014,0,0,0,6,0,6,0,0,0,0,0,0,6,0,6
Uttarakhand,"7 - Immoral Traffic (Prevention) Act, 1956",2014,30,10,40,23,7,30,5,0,5,0,0,0,58,17,75
Uttarakhand,7.1 - Under Section 5,2014,9,1,10,19,2,21,5,0,5,0,0,0,33,3,36
Uttarakhand,7.2 - Under Section 6,2014,0,0,0,0,0,0,0,0,0,0,0,0,0,0,0
Uttarakhand,7.3 - Under Section 7,2014,0,0,0,0,0,0,0,0,0,0,0,0,0,0,0
Uttarakhand,7.4 - Under Section 8,2014,0,0,0,0,0,0,0,0,0,0,0,0,0,0,0
Uttarakhand,7.5 - Other Sections under ITP Act,2014,21,9,30,4,5,9,0,0,0,0,0,0,25,14,39
Uttarakhand,"8 - Indian Railways Act, 1989",2014,0,0,0,0,0,0,0,0,0,0,0,0,0,0,0
Uttarakhand,"9 - Registration of Foreigners Act, 1939",2014,1,0,1,1,0,1,0,0,0,0,0,0,2,0,2
Uttarakhand,"10 - Protection of Civil Rights Act, 1955",2014,0,0,0,0,0,0,0,0,0,0,0,0,0,0,0
Uttarakhand,10.1 - PCR Act for crimes committed against SCs,2014,0,0,0,0,0,0,0,0,0,0,0,0,0,0,0
Uttarakhand,10.2 - PCR Act for crimes committed against STs,2014,0,0,0,0,0,0,0,0,0,0,0,0,0,0,0
Uttarakhand,10.3 - PCR Act for crimes committed against Others,2014,0,0,0,0,0,0,0,0,0,0,0,0,0,0,0
Uttarakhand,"11 - Passport Act, 1967",2014,0,0,0,0,0,0,0,0,0,0,0,0,0,0,0
Uttarakhand,"12 - Essential Commodities Act, 1955",2014,6,0,6,15,0,15,5,0,5,0,0,0,26,0,26
Uttarakhand,"13 - Antiquities & Art Treasures Act, 1972",2014,0,0,0,0,0,0,0,0,0,0,0,0,0,0,0
Uttarakhand,"14 - Dowry Prohibition Act, 1961",2014,66,0,66,39,4,43,22,2,24,0,0,0,127,6,133
Uttarakhand,"15 - Indecent Representation of Women (Prohibition) Act, 1986",2014,0,0,0,0,0,0,0,0,0,0,0,0,0,0,0
Uttarakhand,"16 - Copyright Act, 1957",2014,10,0,10,13,0,13,0,0,0,0,0,0,23,0,23
Uttarakhand,17 - Commission of Sati Prevention Act 1987,2014,0,0,0,0,0,0,0,0,0,0,0,0,0,0,0
Uttarakhand,"18 - SC/ST (Prevention of Atrocities) Act, 1989)",2014,7,0,7,12,0,12,4,0,4,0,0,0,23,0,23
Uttarakhand,18.1 - POA Act for crimes committed against SCs,2014,6,0,6,11,0,11,4,0,4,0,0,0,21,0,21
Uttarakhand,18.2 - POA Act for crimes committed against STs,2014,1,0,1,1,0,1,0,0,0,0,0,0,2,0,2
Uttarakhand,"19 - Forest Act, 1927",2014,14,0,14,43,0,43,1,0,1,0,0,0,58,0,58
Uttarakhand,"20 - Prohibition of Child Marriage Act, 2006",2014,0,0,0,0,0,0,0,0,0,0,0,0,0,0,0
Uttarakhand,"21 - Protection of Women from Domestic Violence Act, 2005",2014,0,0,0,0,0,0,0,0,0,0,0,0,0,0,0
Uttarakhand,"22 - Information Technology Act, 2000",2014,21,0,21,18,0,18,0,0,0,0,0,0,39,0,39
Uttarakhand,"23 - Official Secrets Act, 1923",2014,0,0,0,0,0,0,0,0,0,0,0,0,0,0,0
Uttarakhand,"24 - Electricity Act, 2003",2014,4,0,4,38,1,39,40,0,40,4,0,4,86,1,87
Uttarakhand,"25 - Wildlife Protection Act, 1972",2014,8,0,8,3,0,3,0,0,0,0,0,0,11,0,11
Uttarakhand,"26 - Bonded Labour System (Abolition) Act, 1976",2014,0,0,0,2,0,2,5,0,5,0,0,0,7,0,7
Uttarakhand,26.1 - Against SCs,2014,0,0,0,0,0,0,0,0,0,0,0,0,0,0,0
Uttarakhand,26.2 - Against STs,2014,0,0,0,0,0,0,0,0,0,0,0,0,0,0,0
Uttarakhand,26.3 - Against others,2014,0,0,0,2,0,2,5,0,5,0,0,0,7,0,7
Uttarakhand,"27 - Environmental (Protection) Act, 1986",2014,0,0,0,0,0,0,0,0,0,0,0,0,0,0,0
Uttarakhand,"28 - Air (Prevention & Control of Pollution) Act, 1981",2014,0,0,0,0,0,0,0,0,0,0,0,0,0,0,0
Uttarakhand,"29 - Water (Prevention & Control of Pollution) Act, 1974(as amended in 1988)",2014,0,0,0,0,0,0,0,0,0,0,0,0,0,0,0
Uttarakhand,"30 - National Security Act, 1980",2014,0,0,0,0,0,0,0,0,0,0,0,0,0,0,0
Uttarakhand,"31 - Unlawful Activities (Prevention) Act, 1967",2014,0,0,0,0,0,0,0,0,0,0,0,0,0,0,0
Uttarakhand,"32 - Young Persons (Harmful Publications) Act, 1956",2014,0,0,0,0,0,0,0,0,0,0,0,0,0,0,0
Uttarakhand,"33 - Railway Property (Unlawful Possession) Act, 1966",2014,0,0,0,0,0,0,0,0,0,0,0,0,0,0,0
Uttarakhand,"34 - Prevention of Damage to Public Property Act, 1984",2014,3,0,3,2,0,2,0,0,0,0,0,0,5,0,5
Uttarakhand,"35 - Transplantation of Human Organs Act, 1994",2014,0,0,0,0,0,0,0,0,0,0,0,0,0,0,0
Uttarakhand,"36 - Trade Marks Act, 1999",2014,0,0,0,0,0,0,0,0,0,0,0,0,0,0,0
Uttarakhand,"37 - Prevention of Insults to National Honour Act, 1971",2014,0,0,0,0,0,0,0,0,0,0,0,0,0,0,0
Uttarakhand,"38 - State Emblem (Prohibition of Improper Use) Act, 2005",2014,0,0,0,0,0,0,0,0,0,0,0,0,0,0,0
Uttarakhand,"39 - Lotteries (Regulation) Act, 1998",2014,0,0,0,0,0,0,1,0,1,0,0,0,1,0,1
Uttarakhand,"40 - Citizenship Act, 1955",2014,0,0,0,0,0,0,0,0,0,0,0,0,0,0,0
Uttarakhand,"41 - Foreigners Act, 1946",2014,0,0,0,0,0,0,0,0,0,0,0,0,0,0,0
Uttarakhand,"42 - Place of Worship (Special Provisions) Act, 1991",2014,0,0,0,0,0,0,0,0,0,0,0,0,0,0,0
Uttarakhand,"43 - Religious Institution (Prevention of Misuse) Act, 1988",2014,0,0,0,0,0,0,0,0,0,0,0,0,0,0,0
Uttarakhand,"44 - Representation of People Act, 1951",2014,0,0,0,0,0,0,1,0,1,0,0,0,1,0,1
Uttarakhand,"45 - Emigration Act, 1983",2014,0,0,0,0,0,0,0,0,0,0,0,0,0,0,0
Uttarakhand,"46 - Juvenile Justice (Care and Protection of Children) Act, 2000",2014,0,0,0,1,0,1,0,0,0,0,0,0,1,0,1
Uttarakhand,"47 - Infant Substitutes Regulation Act, 2003",2014,0,0,0,0,0,0,0,0,0,0,0,0,0,0,0
Uttarakhand,"48 - Anti-Hijacking Act, 1982",2014,0,0,0,0,0,0,0,0,0,0,0,0,0,0,0
Uttarakhand,"49 - Atomic Energy Act, 1962",2014,0,0,0,0,0,0,0,0,0,0,0,0,0,0,0
Uttarakhand,"50 - Weapons of Mass Destruction (Proh. of Unlawful Activities) Act, 2005",2014,0,0,0,0,0,0,0,0,0,0,0,0,0,0,0
Uttarakhand,"51 - Suppression of Unlawful Acts against Safety of Civil Aviation Act, 1982",2014,0,0,0,0,0,0,0,0,0,0,0,0,0,0,0
Uttarakhand,"52 - Safety of Maritime Navigation Act, 2002",2014,0,0,0,0,0,0,0,0,0,0,0,0,0,0,0
Uttarakhand,"53 - Manual Scavengers and Construction of Dry Latrines (P) Act, 1993",2014,0,0,0,0,0,0,0,0,0,0,0,0,0,0,0
Uttarakhand,"54 - Pre-Natal Diagnostic Techniques (Reg and Prev of Misuse) Act, 1994",2014,0,0,0,0,0,0,0,0,0,0,0,0,0,0,0
Uttarakhand,"55 - The Maritime Zones of India (Reg of Fishing by Foreign Vessels) Act, 1981",2014,0,0,0,0,0,0,0,0,0,0,0,0,0,0,0
Uttarakhand,56 - Other SLL crimes,2014,98098,23,98121,57557,13,57570,11397,0,11397,1,0,1,167053,36,167089
Uttarakhand,57 - Total Cognizable SLL crimes,2014,100106,70,100176,59519,58,59577,11760,9,11769,11,0,11,171396,137,171533
West Bengal,"1 - Arms Act, 1959",2014,2632,0,2632,1678,0,1678,341,0,341,2,0,2,4653,0,4653
West Bengal,"2 - Narcotic Drugs & Psychotropic Substances Act, 1985",2014,905,23,928,566,24,590,129,2,131,2,0,2,1602,49,1651
West Bengal,"3 - Gambling Act, 1867",2014,612,3,615,702,0,702,165,0,165,3,0,3,1482,3,1485
West Bengal,"4 - Excise Act, 1944",2014,1553,33,1586,1693,81,1774,811,20,831,18,6,24,4075,140,4215
West Bengal,5 - Prohibition Act,2014,0,0,0,0,0,0,0,0,0,0,0,0,0,0,0
West Bengal,6 - Explosives and Explosive Substances Act,2014,191,0,191,133,0,133,29,0,29,4,0,4,357,0,357
West Bengal,"7 - Immoral Traffic (Prevention) Act, 1956",2014,199,80,279,200,60,260,32,10,42,0,0,0,431,150,581
West Bengal,7.1 - Under Section 5,2014,73,34,107,45,16,61,2,1,3,0,0,0,120,51,171
West Bengal,7.2 - Under Section 6,2014,6,0,6,23,2,25,4,2,6,0,0,0,33,4,37
West Bengal,7.3 - Under Section 7,2014,3,0,3,11,3,14,0,0,0,0,0,0,14,3,17
West Bengal,7.4 - Under Section 8,2014,0,0,0,10,0,10,6,0,6,0,0,0,16,0,16
West Bengal,7.5 - Other Sections under ITP Act,2014,117,46,163,111,39,150,20,7,27,0,0,0,248,92,340
West Bengal,"8 - Indian Railways Act, 1989",2014,0,0,0,1,0,1,0,0,0,0,0,0,1,0,1
West Bengal,"9 - Registration of Foreigners Act, 1939",2014,369,34,403,210,16,226,77,3,80,2,0,2,658,53,711
West Bengal,"10 - Protection of Civil Rights Act, 1955",2014,0,0,0,0,0,0,0,0,0,0,0,0,0,0,0
West Bengal,10.1 - PCR Act for crimes committed against SCs,2014,0,0,0,0,0,0,0,0,0,0,0,0,0,0,0
West Bengal,10.2 - PCR Act for crimes committed against STs,2014,0,0,0,0,0,0,0,0,0,0,0,0,0,0,0
West Bengal,10.3 - PCR Act for crimes committed against Others,2014,0,0,0,0,0,0,0,0,0,0,0,0,0,0,0
West Bengal,"11 - Passport Act, 1967",2014,73,0,73,75,0,75,4,0,4,0,0,0,152,0,152
West Bengal,"12 - Essential Commodities Act, 1955",2014,134,0,134,222,0,222,56,0,56,5,0,5,417,0,417
West Bengal,"13 - Antiquities & Art Treasures Act, 1972",2014,4,0,4,10,0,10,1,0,1,0,0,0,15,0,15
West Bengal,"14 - Dowry Prohibition Act, 1961",2014,25,5,30,43,6,49,28,0,28,0,0,0,96,11,107
West Bengal,"15 - Indecent Representation of Women (Prohibition) Act, 1986",2014,3,0,3,1,0,1,0,0,0,0,0,0,4,0,4
West Bengal,"16 - Copyright Act, 1957",2014,366,0,366,258,0,258,115,0,115,4,0,4,743,0,743
West Bengal,17 - Commission of Sati Prevention Act 1987,2014,0,0,0,0,0,0,0,0,0,0,0,0,0,0,0
West Bengal,"18 - SC/ST (Prevention of Atrocities) Act, 1989)",2014,17,0,17,48,0,48,9,0,9,0,0,0,74,0,74
West Bengal,18.1 - POA Act for crimes committed against SCs,2014,9,0,9,32,0,32,9,0,9,0,0,0,50,0,50
West Bengal,18.2 - POA Act for crimes committed against STs,2014,8,0,8,16,0,16,0,0,0,0,0,0,24,0,24
West Bengal,"19 - Forest Act, 1927",2014,32,0,32,20,0,20,12,0,12,0,0,0,64,0,64
West Bengal,"20 - Prohibition of Child Marriage Act, 2006",2014,26,0,26,33,3,36,12,0,12,0,0,0,71,3,74
West Bengal,"21 - Protection of Women from Domestic Violence Act, 2005",2014,0,0,0,3,0,3,0,0,0,0,0,0,3,0,3
West Bengal,"22 - Information Technology Act, 2000",2014,97,1,98,86,0,86,18,1,19,0,0,0,201,2,203
West Bengal,"23 - Official Secrets Act, 1923",2014,0,0,0,0,0,0,0,0,0,0,0,0,0,0,0
West Bengal,"24 - Electricity Act, 2003",2014,2174,1,2175,2527,2,2529,1305,0,1305,76,0,76,6082,3,6085
West Bengal,"25 - Wildlife Protection Act, 1972",2014,8,0,8,19,2,21,2,3,5,0,0,0,29,5,34
West Bengal,"26 - Bonded Labour System (Abolition) Act, 1976",2014,0,0,0,0,0,0,0,0,0,0,0,0,0,0,0
West Bengal,26.1 - Against SCs,2014,0,0,0,0,0,0,0,0,0,0,0,0,0,0,0
West Bengal,26.2 - Against STs,2014,0,0,0,0,0,0,0,0,0,0,0,0,0,0,0
West Bengal,26.3 - Against others,2014,0,0,0,0,0,0,0,0,0,0,0,0,0,0,0
West Bengal,"27 - Environmental (Protection) Act, 1986",2014,4,0,4,11,0,11,11,0,11,0,0,0,26,0,26
West Bengal,"28 - Air (Prevention & Control of Pollution) Act, 1981",2014,3,0,3,7,0,7,15,0,15,6,0,6,31,0,31
West Bengal,"29 - Water (Prevention & Control of Pollution) Act, 1974(as amended in 1988)",2014,7,0,7,5,0,5,0,0,0,0,0,0,12,0,12
West Bengal,"30 - National Security Act, 1980",2014,0,0,0,0,0,0,0,0,0,0,0,0,0,0,0
West Bengal,"31 - Unlawful Activities (Prevention) Act, 1967",2014,1,0,1,0,0,0,0,0,0,0,0,0,1,0,1
West Bengal,"32 - Young Persons (Harmful Publications) Act, 1956",2014,0,0,0,0,0,0,0,0,0,0,0,0,0,0,0
West Bengal,"33 - Railway Property (Unlawful Possession) Act, 1966",2014,0,0,0,0,0,0,0,0,0,0,0,0,0,0,0
West Bengal,"34 - Prevention of Damage to Public Property Act, 1984",2014,18,0,18,20,2,22,8,0,8,1,0,1,47,2,49
West Bengal,"35 - Transplantation of Human Organs Act, 1994",2014,0,0,0,0,0,0,0,0,0,0,0,0,0,0,0
West Bengal,"36 - Trade Marks Act, 1999",2014,23,0,23,18,0,18,13,0,13,0,0,0,54,0,54
West Bengal,"37 - Prevention of Insults to National Honour Act, 1971",2014,1,0,1,0,0,0,0,0,0,0,0,0,1,0,1
West Bengal,"38 - State Emblem (Prohibition of Improper Use) Act, 2005",2014,0,0,0,0,0,0,0,0,0,0,0,0,0,0,0
West Bengal,"39 - Lotteries (Regulation) Act, 1998",2014,0,0,0,1,0,1,0,0,0,0,0,0,1,0,1
West Bengal,"40 - Citizenship Act, 1955",2014,8,0,8,6,0,6,0,0,0,0,0,0,14,0,14
West Bengal,"41 - Foreigners Act, 1946",2014,1327,89,1416,1414,48,1462,464,49,513,2,0,2,3207,186,3393
West Bengal,"42 - Place of Worship (Special Provisions) Act, 1991",2014,0,0,0,0,0,0,0,0,0,0,0,0,0,0,0
West Bengal,"43 - Religious Institution (Prevention of Misuse) Act, 1988",2014,0,0,0,0,0,0,0,0,0,0,0,0,0,0,0
West Bengal,"44 - Representation of People Act, 1951",2014,14,0,14,18,0,18,7,0,7,0,0,0,39,0,39
West Bengal,"45 - Emigration Act, 1983",2014,0,0,0,6,0,6,0,0,0,0,0,0,6,0,6
West Bengal,"46 - Juvenile Justice (Care and Protection of Children) Act, 2000",2014,11,2,13,6,0,6,4,2,6,0,0,0,21,4,25
West Bengal,"47 - Infant Substitutes Regulation Act, 2003",2014,0,0,0,0,0,0,0,0,0,0,0,0,0,0,0
West Bengal,"48 - Anti-Hijacking Act, 1982",2014,0,0,0,0,0,0,0,0,0,0,0,0,0,0,0
West Bengal,"49 - Atomic Energy Act, 1962",2014,0,0,0,0,0,0,0,0,0,0,0,0,0,0,0
West Bengal,"50 - Weapons of Mass Destruction (Proh. of Unlawful Activities) Act, 2005",2014,0,0,0,0,0,0,0,0,0,0,0,0,0,0,0
West Bengal,"51 - Suppression of Unlawful Acts against Safety of Civil Aviation Act, 1982",2014,0,0,0,0,0,0,0,0,0,0,0,0,0,0,0
West Bengal,"52 - Safety of Maritime Navigation Act, 2002",2014,0,0,0,0,0,0,0,0,0,0,0,0,0,0,0
West Bengal,"53 - Manual Scavengers and Construction of Dry Latrines (P) Act, 1993",2014,0,0,0,0,0,0,0,0,0,0,0,0,0,0,0
West Bengal,"54 - Pre-Natal Diagnostic Techniques (Reg and Prev of Misuse) Act, 1994",2014,1,0,1,0,0,0,0,0,0,0,0,0,1,0,1
West Bengal,"55 - The Maritime Zones of India (Reg of Fishing by Foreign Vessels) Act, 1981",2014,0,0,0,0,0,0,0,0,0,0,0,0,0,0,0
West Bengal,56 - Other SLL crimes,2014,2090,118,2208,2458,94,2552,936,36,972,71,5,76,5555,253,5808
West Bengal,57 - Total Cognizable SLL crimes,2014,12928,389,13317,12498,338,12836,4604,126,4730,196,11,207,30226,864,31090
A & N Islands,"1 - Arms Act, 1959",2014,0,0,0,0,0,0,0,0,0,0,0,0,0,0,0
A & N Islands,"2 - Narcotic Drugs & Psychotropic Substances Act, 1985",2014,15,1,16,14,0,14,11,0,11,3,0,3,43,1,44
A & N Islands,"3 - Gambling Act, 1867",2014,131,0,131,280,0,280,78,0,78,12,0,12,501,0,501
A & N Islands,"4 - Excise Act, 1944",2014,289,17,306,751,97,848,567,68,635,146,31,177,1753,213,1966
A & N Islands,5 - Prohibition Act,2014,28,0,28,19,0,19,6,0,6,0,0,0,53,0,53
A & N Islands,6 - Explosives and Explosive Substances Act,2014,0,0,0,0,0,0,0,0,0,0,0,0,0,0,0
A & N Islands,"7 - Immoral Traffic (Prevention) Act, 1956",2014,6,17,23,2,12,14,0,0,0,2,1,3,10,30,40
A & N Islands,7.1 - Under Section 5,2014,6,17,23,2,9,11,0,0,0,2,1,3,10,27,37
A & N Islands,7.2 - Under Section 6,2014,0,0,0,0,3,3,0,0,0,0,0,0,0,3,3
A & N Islands,7.3 - Under Section 7,2014,0,0,0,0,0,0,0,0,0,0,0,0,0,0,0
A & N Islands,7.4 - Under Section 8,2014,0,0,0,0,0,0,0,0,0,0,0,0,0,0,0
A & N Islands,7.5 - Other Sections under ITP Act,2014,0,0,0,0,0,0,0,0,0,0,0,0,0,0,0
A & N Islands,"8 - Indian Railways Act, 1989",2014,0,0,0,0,0,0,0,0,0,0,0,0,0,0,0
A & N Islands,"9 - Registration of Foreigners Act, 1939",2014,0,0,0,0,0,0,0,0,0,0,0,0,0,0,0
A & N Islands,"10 - Protection of Civil Rights Act, 1955",2014,0,0,0,0,0,0,0,0,0,0,0,0,0,0,0
A & N Islands,10.1 - PCR Act for crimes committed against SCs,2014,0,0,0,0,0,0,0,0,0,0,0,0,0,0,0
A & N Islands,10.2 - PCR Act for crimes committed against STs,2014,0,0,0,0,0,0,0,0,0,0,0,0,0,0,0
A & N Islands,10.3 - PCR Act for crimes committed against Others,2014,0,0,0,0,0,0,0,0,0,0,0,0,0,0,0
A & N Islands,"11 - Passport Act, 1967",2014,0,0,0,0,0,0,0,0,0,0,0,0,0,0,0
A & N Islands,"12 - Essential Commodities Act, 1955",2014,0,0,0,0,0,0,1,0,1,0,0,0,1,0,1
A & N Islands,"13 - Antiquities & Art Treasures Act, 1972",2014,0,0,0,0,0,0,0,0,0,0,0,0,0,0,0
A & N Islands,"14 - Dowry Prohibition Act, 1961",2014,0,0,0,0,0,0,0,0,0,0,0,0,0,0,0
A & N Islands,"15 - Indecent Representation of Women (Prohibition) Act, 1986",2014,0,0,0,0,0,0,0,0,0,0,0,0,0,0,0
A & N Islands,"16 - Copyright Act, 1957",2014,0,0,0,0,0,0,0,0,0,0,0,0,0,0,0
A & N Islands,17 - Commission of Sati Prevention Act 1987,2014,0,0,0,0,0,0,0,0,0,0,0,0,0,0,0
A & N Islands,"18 - SC/ST (Prevention of Atrocities) Act, 1989)",2014,1,0,1,1,0,1,0,0,0,0,0,0,2,0,2
A & N Islands,18.1 - POA Act for crimes committed against SCs,2014,0,0,0,0,0,0,0,0,0,0,0,0,0,0,0
A & N Islands,18.2 - POA Act for crimes committed against STs,2014,1,0,1,1,0,1,0,0,0,0,0,0,2,0,2
A & N Islands,"19 - Forest Act, 1927",2014,0,0,0,0,0,0,0,0,0,0,0,0,0,0,0
A & N Islands,"20 - Prohibition of Child Marriage Act, 2006",2014,0,0,0,0,0,0,0,0,0,0,0,0,0,0,0
A & N Islands,"21 - Protection of Women from Domestic Violence Act, 2005",2014,0,0,0,0,0,0,0,0,0,0,0,0,0,0,0
A & N Islands,"22 - Information Technology Act, 2000",2014,1,0,1,1,0,1,0,0,0,0,0,0,2,0,2
A & N Islands,"23 - Official Secrets Act, 1923",2014,0,0,0,0,0,0,0,0,0,0,0,0,0,0,0
A & N Islands,"24 - Electricity Act, 2003",2014,0,0,0,0,0,0,0,0,0,0,0,0,0,0,0
A & N Islands,"25 - Wildlife Protection Act, 1972",2014,0,0,0,0,0,0,0,0,0,0,0,0,0,0,0
A & N Islands,"26 - Bonded Labour System (Abolition) Act, 1976",2014,0,0,0,0,0,0,0,0,0,0,0,0,0,0,0
A & N Islands,26.1 - Against SCs,2014,0,0,0,0,0,0,0,0,0,0,0,0,0,0,0
A & N Islands,26.2 - Against STs,2014,0,0,0,0,0,0,0,0,0,0,0,0,0,0,0
A & N Islands,26.3 - Against others,2014,0,0,0,0,0,0,0,0,0,0,0,0,0,0,0
A & N Islands,"27 - Environmental (Protection) Act, 1986",2014,0,0,0,0,0,0,0,0,0,0,0,0,0,0,0
A & N Islands,"28 - Air (Prevention & Control of Pollution) Act, 1981",2014,0,0,0,0,0,0,0,0,0,0,0,0,0,0,0
A & N Islands,"29 - Water (Prevention & Control of Pollution) Act, 1974(as amended in 1988)",2014,0,0,0,0,0,0,0,0,0,0,0,0,0,0,0
A & N Islands,"30 - National Security Act, 1980",2014,0,0,0,0,0,0,0,0,0,0,0,0,0,0,0
A & N Islands,"31 - Unlawful Activities (Prevention) Act, 1967",2014,0,0,0,0,0,0,0,0,0,0,0,0,0,0,0
A & N Islands,"32 - Young Persons (Harmful Publications) Act, 1956",2014,0,0,0,0,0,0,0,0,0,0,0,0,0,0,0
A & N Islands,"33 - Railway Property (Unlawful Possession) Act, 1966",2014,0,0,0,0,0,0,0,0,0,0,0,0,0,0,0
A & N Islands,"34 - Prevention of Damage to Public Property Act, 1984",2014,0,0,0,0,0,0,1,0,1,0,0,0,1,0,1
A & N Islands,"35 - Transplantation of Human Organs Act, 1994",2014,0,0,0,0,0,0,0,0,0,0,0,0,0,0,0
A & N Islands,"36 - Trade Marks Act, 1999",2014,0,0,0,0,0,0,0,0,0,0,0,0,0,0,0
A & N Islands,"37 - Prevention of Insults to National Honour Act, 1971",2014,0,0,0,0,0,0,0,0,0,0,0,0,0,0,0
A & N Islands,"38 - State Emblem (Prohibition of Improper Use) Act, 2005",2014,0,0,0,0,0,0,0,0,0,0,0,0,0,0,0
A & N Islands,"39 - Lotteries (Regulation) Act, 1998",2014,0,0,0,0,0,0,0,0,0,0,0,0,0,0,0
A & N Islands,"40 - Citizenship Act, 1955",2014,0,0,0,0,0,0,0,0,0,0,0,0,0,0,0
A & N Islands,"41 - Foreigners Act, 1946",2014,1,0,1,0,0,0,0,0,0,0,0,0,1,0,1
A & N Islands,"42 - Place of Worship (Special Provisions) Act, 1991",2014,0,0,0,0,0,0,0,0,0,0,0,0,0,0,0
A & N Islands,"43 - Religious Institution (Prevention of Misuse) Act, 1988",2014,0,0,0,0,0,0,0,0,0,0,0,0,0,0,0
A & N Islands,"44 - Representation of People Act, 1951",2014,0,0,0,0,0,0,0,0,0,0,0,0,0,0,0
A & N Islands,"45 - Emigration Act, 1983",2014,0,0,0,0,0,0,0,0,0,0,0,0,0,0,0
A & N Islands,"46 - Juvenile Justice (Care and Protection of Children) Act, 2000",2014,0,0,0,0,1,1,0,0,0,0,0,0,0,1,1
A & N Islands,"47 - Infant Substitutes Regulation Act, 2003",2014,0,0,0,0,0,0,0,0,0,0,0,0,0,0,0
A & N Islands,"48 - Anti-Hijacking Act, 1982",2014,0,0,0,0,0,0,0,0,0,0,0,0,0,0,0
A & N Islands,"49 - Atomic Energy Act, 1962",2014,0,0,0,0,0,0,0,0,0,0,0,0,0,0,0
A & N Islands,"50 - Weapons of Mass Destruction (Proh. of Unlawful Activities) Act, 2005",2014,0,0,0,0,0,0,0,0,0,0,0,0,0,0,0
A & N Islands,"51 - Suppression of Unlawful Acts against Safety of Civil Aviation Act, 1982",2014,0,0,0,0,0,0,0,0,0,0,0,0,0,0,0
A & N Islands,"52 - Safety of Maritime Navigation Act, 2002",2014,0,0,0,0,0,0,0,0,0,0,0,0,0,0,0
A & N Islands,"53 - Manual Scavengers and Construction of Dry Latrines (P) Act, 1993",2014,0,0,0,0,0,0,0,0,0,0,0,0,0,0,0
A & N Islands,"54 - Pre-Natal Diagnostic Techniques (Reg and Prev of Misuse) Act, 1994",2014,0,0,0,0,0,0,0,0,0,0,0,0,0,0,0
A & N Islands,"55 - The Maritime Zones of India (Reg of Fishing by Foreign Vessels) Act, 1981",2014,2,0,2,8,0,8,12,0,12,1,0,1,23,0,23
A & N Islands,56 - Other SLL crimes,2014,1,0,1,4,0,4,1,0,1,1,0,1,7,0,7
A & N Islands,57 - Total Cognizable SLL crimes,2014,475,35,510,1080,110,1190,677,68,745,165,32,197,2397,245,2642
Chandigarh,"1 - Arms Act, 1959",2014,10,0,10,8,0,8,0,0,0,0,0,0,18,0,18
Chandigarh,"2 - Narcotic Drugs & Psychotropic Substances Act, 1985",2014,53,4,57,46,6,52,30,0,30,0,0,0,129,10,139
Chandigarh,"3 - Gambling Act, 1867",2014,194,0,194,168,0,168,79,0,79,22,0,22,463,0,463
Chandigarh,"4 - Excise Act, 1944",2014,469,17,486,374,14,388,102,4,106,19,0,19,964,35,999
Chandigarh,5 - Prohibition Act,2014,0,0,0,0,0,0,0,0,0,0,0,0,0,0,0
Chandigarh,6 - Explosives and Explosive Substances Act,2014,0,0,0,0,0,0,0,0,0,0,0,0,0,0,0
Chandigarh,"7 - Immoral Traffic (Prevention) Act, 1956",2014,1,2,3,0,0,0,0,0,0,0,0,0,1,2,3
Chandigarh,7.1 - Under Section 5,2014,0,0,0,0,0,0,0,0,0,0,0,0,0,0,0
Chandigarh,7.2 - Under Section 6,2014,0,0,0,0,0,0,0,0,0,0,0,0,0,0,0
Chandigarh,7.3 - Under Section 7,2014,0,0,0,0,0,0,0,0,0,0,0,0,0,0,0
Chandigarh,7.4 - Under Section 8,2014,0,0,0,0,0,0,0,0,0,0,0,0,0,0,0
Chandigarh,7.5 - Other Sections under ITP Act,2014,1,2,3,0,0,0,0,0,0,0,0,0,1,2,3
Chandigarh,"8 - Indian Railways Act, 1989",2014,0,0,0,0,0,0,0,0,0,0,0,0,0,0,0
Chandigarh,"9 - Registration of Foreigners Act, 1939",2014,0,0,0,0,0,0,0,0,0,0,0,0,0,0,0
Chandigarh,"10 - Protection of Civil Rights Act, 1955",2014,0,0,0,0,0,0,0,0,0,0,0,0,0,0,0
Chandigarh,10.1 - PCR Act for crimes committed against SCs,2014,0,0,0,0,0,0,0,0,0,0,0,0,0,0,0
Chandigarh,10.2 - PCR Act for crimes committed against STs,2014,0,0,0,0,0,0,0,0,0,0,0,0,0,0,0
Chandigarh,10.3 - PCR Act for crimes committed against Others,2014,0,0,0,0,0,0,0,0,0,0,0,0,0,0,0
Chandigarh,"11 - Passport Act, 1967",2014,0,0,0,0,0,0,0,0,0,0,0,0,0,0,0
Chandigarh,"12 - Essential Commodities Act, 1955",2014,0,0,0,4,0,4,2,0,2,0,0,0,6,0,6
Chandigarh,"13 - Antiquities & Art Treasures Act, 1972",2014,0,0,0,0,0,0,0,0,0,0,0,0,0,0,0
Chandigarh,"14 - Dowry Prohibition Act, 1961",2014,0,0,0,0,0,0,0,0,0,0,0,0,0,0,0
Chandigarh,"15 - Indecent Representation of Women (Prohibition) Act, 1986",2014,0,0,0,0,0,0,0,0,0,0,0,0,0,0,0
Chandigarh,"16 - Copyright Act, 1957",2014,5,0,5,8,0,8,7,0,7,2,0,2,22,0,22
Chandigarh,17 - Commission of Sati Prevention Act 1987,2014,0,0,0,0,0,0,0,0,0,0,0,0,0,0,0
Chandigarh,"18 - SC/ST (Prevention of Atrocities) Act, 1989)",2014,0,0,0,2,0,2,2,0,2,0,0,0,4,0,4
Chandigarh,18.1 - POA Act for crimes committed against SCs,2014,0,0,0,2,0,2,2,0,2,0,0,0,4,0,4
Chandigarh,18.2 - POA Act for crimes committed against STs,2014,0,0,0,0,0,0,0,0,0,0,0,0,0,0,0
Chandigarh,"19 - Forest Act, 1927",2014,0,0,0,0,0,0,0,0,0,0,0,0,0,0,0
Chandigarh,"20 - Prohibition of Child Marriage Act, 2006",2014,0,0,0,0,0,0,0,0,0,0,0,0,0,0,0
Chandigarh,"21 - Protection of Women from Domestic Violence Act, 2005",2014,0,0,0,0,0,0,0,0,0,0,0,0,0,0,0
Chandigarh,"22 - Information Technology Act, 2000",2014,6,0,6,8,0,8,0,0,0,0,0,0,14,0,14
Chandigarh,"23 - Official Secrets Act, 1923",2014,0,0,0,0,0,0,0,0,0,0,0,0,0,0,0
Chandigarh,"24 - Electricity Act, 2003",2014,0,0,0,0,0,0,0,0,0,0,0,0,0,0,0
Chandigarh,"25 - Wildlife Protection Act, 1972",2014,0,0,0,0,0,0,0,0,0,0,0,0,0,0,0
Chandigarh,"26 - Bonded Labour System (Abolition) Act, 1976",2014,0,0,0,0,0,0,0,0,0,0,0,0,0,0,0
Chandigarh,26.1 - Against SCs,2014,0,0,0,0,0,0,0,0,0,0,0,0,0,0,0
Chandigarh,26.2 - Against STs,2014,0,0,0,0,0,0,0,0,0,0,0,0,0,0,0
Chandigarh,26.3 - Against others,2014,0,0,0,0,0,0,0,0,0,0,0,0,0,0,0
Chandigarh,"27 - Environmental (Protection) Act, 1986",2014,0,0,0,0,0,0,0,0,0,0,0,0,0,0,0
Chandigarh,"28 - Air (Prevention & Control of Pollution) Act, 1981",2014,0,0,0,0,0,0,0,0,0,0,0,0,0,0,0
Chandigarh,"29 - Water (Prevention & Control of Pollution) Act, 1974(as amended in 1988)",2014,0,0,0,0,0,0,0,0,0,0,0,0,0,0,0
Chandigarh,"30 - National Security Act, 1980",2014,0,0,0,0,0,0,0,0,0,0,0,0,0,0,0
Chandigarh,"31 - Unlawful Activities (Prevention) Act, 1967",2014,0,0,0,0,0,0,0,0,0,0,0,0,0,0,0
Chandigarh,"32 - Young Persons (Harmful Publications) Act, 1956",2014,0,0,0,0,0,0,0,0,0,0,0,0,0,0,0
Chandigarh,"33 - Railway Property (Unlawful Possession) Act, 1966",2014,0,0,0,0,0,0,0,0,0,0,0,0,0,0,0
Chandigarh,"34 - Prevention of Damage to Public Property Act, 1984",2014,0,0,0,0,0,0,0,0,0,0,0,0,0,0,0
Chandigarh,"35 - Transplantation of Human Organs Act, 1994",2014,0,0,0,0,0,0,0,0,0,0,0,0,0,0,0
Chandigarh,"36 - Trade Marks Act, 1999",2014,0,0,0,0,0,0,0,0,0,0,0,0,0,0,0
Chandigarh,"37 - Prevention of Insults to National Honour Act, 1971",2014,0,0,0,0,0,0,0,0,0,0,0,0,0,0,0
Chandigarh,"38 - State Emblem (Prohibition of Improper Use) Act, 2005",2014,0,0,0,0,0,0,0,0,0,0,0,0,0,0,0
Chandigarh,"39 - Lotteries (Regulation) Act, 1998",2014,0,0,0,0,0,0,0,0,0,0,0,0,0,0,0
Chandigarh,"40 - Citizenship Act, 1955",2014,0,0,0,0,0,0,0,0,0,0,0,0,0,0,0
Chandigarh,"41 - Foreigners Act, 1946",2014,0,0,0,0,0,0,0,0,0,0,0,0,0,0,0
Chandigarh,"42 - Place of Worship (Special Provisions) Act, 1991",2014,0,0,0,0,0,0,0,0,0,0,0,0,0,0,0
Chandigarh,"43 - Religious Institution (Prevention of Misuse) Act, 1988",2014,0,0,0,0,0,0,0,0,0,0,0,0,0,0,0
Chandigarh,"44 - Representation of People Act, 1951",2014,0,0,0,0,0,0,0,0,0,0,0,0,0,0,0
Chandigarh,"45 - Emigration Act, 1983",2014,0,0,0,0,0,0,0,0,0,0,0,0,0,0,0
Chandigarh,"46 - Juvenile Justice (Care and Protection of Children) Act, 2000",2014,3,0,3,5,0,5,4,0,4,0,0,0,12,0,12
Chandigarh,"47 - Infant Substitutes Regulation Act, 2003",2014,0,0,0,0,0,0,0,0,0,0,0,0,0,0,0
Chandigarh,"48 - Anti-Hijacking Act, 1982",2014,0,0,0,0,0,0,0,0,0,0,0,0,0,0,0
Chandigarh,"49 - Atomic Energy Act, 1962",2014,0,0,0,0,0,0,0,0,0,0,0,0,0,0,0
Chandigarh,"50 - Weapons of Mass Destruction (Proh. of Unlawful Activities) Act, 2005",2014,0,0,0,0,0,0,0,0,0,0,0,0,0,0,0
Chandigarh,"51 - Suppression of Unlawful Acts against Safety of Civil Aviation Act, 1982",2014,0,0,0,0,0,0,0,0,0,0,0,0,0,0,0
Chandigarh,"52 - Safety of Maritime Navigation Act, 2002",2014,0,0,0,0,0,0,0,0,0,0,0,0,0,0,0
Chandigarh,"53 - Manual Scavengers and Construction of Dry Latrines (P) Act, 1993",2014,0,0,0,0,0,0,0,0,0,0,0,0,0,0,0
Chandigarh,"54 - Pre-Natal Diagnostic Techniques (Reg and Prev of Misuse) Act, 1994",2014,0,0,0,0,0,0,0,0,0,0,0,0,0,0,0
Chandigarh,"55 - The Maritime Zones of India (Reg of Fishing by Foreign Vessels) Act, 1981",2014,0,0,0,0,0,0,0,0,0,0,0,0,0,0,0
Chandigarh,56 - Other SLL crimes,2014,14,0,14,21,0,21,11,0,11,0,0,0,46,0,46
Chandigarh,57 - Total Cognizable SLL crimes,2014,755,23,778,644,20,664,237,4,241,43,0,43,1679,47,1726
D&N Haveli,"1 - Arms Act, 1959",2014,0,0,0,0,0,0,0,0,0,0,0,0,0,0,0
D&N Haveli,"2 - Narcotic Drugs & Psychotropic Substances Act, 1985",2014,2,0,2,0,0,0,0,0,0,0,0,0,2,0,2
D&N Haveli,"3 - Gambling Act, 1867",2014,2,0,2,10,0,10,4,0,4,0,0,0,16,0,16
D&N Haveli,"4 - Excise Act, 1944",2014,9,0,9,8,0,8,0,0,0,0,0,0,17,0,17
D&N Haveli,5 - Prohibition Act,2014,0,0,0,0,0,0,0,0,0,0,0,0,0,0,0
D&N Haveli,6 - Explosives and Explosive Substances Act,2014,0,0,0,0,0,0,0,0,0,0,0,0,0,0,0
D&N Haveli,"7 - Immoral Traffic (Prevention) Act, 1956",2014,3,2,5,2,0,2,0,0,0,0,0,0,5,2,7
D&N Haveli,7.1 - Under Section 5,2014,0,0,0,0,0,0,0,0,0,0,0,0,0,0,0
D&N Haveli,7.2 - Under Section 6,2014,0,0,0,0,0,0,0,0,0,0,0,0,0,0,0
D&N Haveli,7.3 - Under Section 7,2014,0,0,0,0,0,0,0,0,0,0,0,0,0,0,0
D&N Haveli,7.4 - Under Section 8,2014,0,0,0,0,0,0,0,0,0,0,0,0,0,0,0
D&N Haveli,7.5 - Other Sections under ITP Act,2014,3,2,5,2,0,2,0,0,0,0,0,0,5,2,7
D&N Haveli,"8 - Indian Railways Act, 1989",2014,0,0,0,0,0,0,0,0,0,0,0,0,0,0,0
D&N Haveli,"9 - Registration of Foreigners Act, 1939",2014,0,0,0,0,0,0,0,0,0,0,0,0,0,0,0
D&N Haveli,"10 - Protection of Civil Rights Act, 1955",2014,0,0,0,0,0,0,0,0,0,0,0,0,0,0,0
D&N Haveli,10.1 - PCR Act for crimes committed against SCs,2014,0,0,0,0,0,0,0,0,0,0,0,0,0,0,0
D&N Haveli,10.2 - PCR Act for crimes committed against STs,2014,0,0,0,0,0,0,0,0,0,0,0,0,0,0,0
D&N Haveli,10.3 - PCR Act for crimes committed against Others,2014,0,0,0,0,0,0,0,0,0,0,0,0,0,0,0
D&N Haveli,"11 - Passport Act, 1967",2014,0,0,0,0,0,0,0,0,0,0,0,0,0,0,0
D&N Haveli,"12 - Essential Commodities Act, 1955",2014,0,0,0,0,0,0,0,0,0,0,0,0,0,0,0
D&N Haveli,"13 - Antiquities & Art Treasures Act, 1972",2014,0,0,0,0,0,0,0,0,0,0,0,0,0,0,0
D&N Haveli,"14 - Dowry Prohibition Act, 1961",2014,0,0,0,0,0,0,0,0,0,0,0,0,0,0,0
D&N Haveli,"15 - Indecent Representation of Women (Prohibition) Act, 1986",2014,0,0,0,0,0,0,0,0,0,0,0,0,0,0,0
D&N Haveli,"16 - Copyright Act, 1957",2014,0,0,0,0,0,0,0,0,0,0,0,0,0,0,0
D&N Haveli,17 - Commission of Sati Prevention Act 1987,2014,0,0,0,0,0,0,0,0,0,0,0,0,0,0,0
D&N Haveli,"18 - SC/ST (Prevention of Atrocities) Act, 1989)",2014,0,0,0,1,0,1,0,0,0,0,0,0,1,0,1
D&N Haveli,18.1 - POA Act for crimes committed against SCs,2014,0,0,0,0,0,0,0,0,0,0,0,0,0,0,0
D&N Haveli,18.2 - POA Act for crimes committed against STs,2014,0,0,0,1,0,1,0,0,0,0,0,0,1,0,1
D&N Haveli,"19 - Forest Act, 1927",2014,0,0,0,0,0,0,0,0,0,0,0,0,0,0,0
D&N Haveli,"20 - Prohibition of Child Marriage Act, 2006",2014,0,0,0,0,0,0,0,0,0,0,0,0,0,0,0
D&N Haveli,"21 - Protection of Women from Domestic Violence Act, 2005",2014,0,0,0,0,0,0,0,0,0,0,0,0,0,0,0
D&N Haveli,"22 - Information Technology Act, 2000",2014,1,0,1,0,0,0,0,0,0,0,0,0,1,0,1
D&N Haveli,"23 - Official Secrets Act, 1923",2014,0,0,0,0,0,0,0,0,0,0,0,0,0,0,0
D&N Haveli,"24 - Electricity Act, 2003",2014,0,0,0,0,0,0,0,0,0,0,0,0,0,0,0
D&N Haveli,"25 - Wildlife Protection Act, 1972",2014,0,0,0,0,0,0,0,0,0,0,0,0,0,0,0
D&N Haveli,"26 - Bonded Labour System (Abolition) Act, 1976",2014,0,0,0,0,0,0,0,0,0,0,0,0,0,0,0
D&N Haveli,26.1 - Against SCs,2014,0,0,0,0,0,0,0,0,0,0,0,0,0,0,0
D&N Haveli,26.2 - Against STs,2014,0,0,0,0,0,0,0,0,0,0,0,0,0,0,0
D&N Haveli,26.3 - Against others,2014,0,0,0,0,0,0,0,0,0,0,0,0,0,0,0
D&N Haveli,"27 - Environmental (Protection) Act, 1986",2014,0,0,0,0,0,0,0,0,0,0,0,0,0,0,0
D&N Haveli,"28 - Air (Prevention & Control of Pollution) Act, 1981",2014,0,0,0,0,0,0,0,0,0,0,0,0,0,0,0
D&N Haveli,"29 - Water (Prevention & Control of Pollution) Act, 1974(as amended in 1988)",2014,0,0,0,0,0,0,0,0,0,0,0,0,0,0,0
D&N Haveli,"30 - National Security Act, 1980",2014,0,0,0,0,0,0,0,0,0,0,0,0,0,0,0
D&N Haveli,"31 - Unlawful Activities (Prevention) Act, 1967",2014,0,0,0,0,0,0,0,0,0,0,0,0,0,0,0
D&N Haveli,"32 - Young Persons (Harmful Publications) Act, 1956",2014,0,0,0,0,0,0,0,0,0,0,0,0,0,0,0
D&N Haveli,"33 - Railway Property (Unlawful Possession) Act, 1966",2014,0,0,0,0,0,0,0,0,0,0,0,0,0,0,0
D&N Haveli,"34 - Prevention of Damage to Public Property Act, 1984",2014,0,0,0,0,0,0,0,0,0,0,0,0,0,0,0
D&N Haveli,"35 - Transplantation of Human Organs Act, 1994",2014,0,0,0,0,0,0,0,0,0,0,0,0,0,0,0
D&N Haveli,"36 - Trade Marks Act, 1999",2014,0,0,0,0,0,0,0,0,0,0,0,0,0,0,0
D&N Haveli,"37 - Prevention of Insults to National Honour Act, 1971",2014,0,0,0,0,0,0,0,0,0,0,0,0,0,0,0
D&N Haveli,"38 - State Emblem (Prohibition of Improper Use) Act, 2005",2014,0,0,0,0,0,0,0,0,0,0,0,0,0,0,0
D&N Haveli,"39 - Lotteries (Regulation) Act, 1998",2014,0,0,0,0,0,0,0,0,0,0,0,0,0,0,0
D&N Haveli,"40 - Citizenship Act, 1955",2014,0,0,0,0,0,0,0,0,0,0,0,0,0,0,0
D&N Haveli,"41 - Foreigners Act, 1946",2014,0,0,0,0,0,0,0,0,0,0,0,0,0,0,0
D&N Haveli,"42 - Place of Worship (Special Provisions) Act, 1991",2014,0,0,0,0,0,0,0,0,0,0,0,0,0,0,0
D&N Haveli,"43 - Religious Institution (Prevention of Misuse) Act, 1988",2014,0,0,0,0,0,0,0,0,0,0,0,0,0,0,0
D&N Haveli,"44 - Representation of People Act, 1951",2014,0,0,0,0,0,0,0,0,0,0,0,0,0,0,0
D&N Haveli,"45 - Emigration Act, 1983",2014,0,0,0,0,0,0,0,0,0,0,0,0,0,0,0
D&N Haveli,"46 - Juvenile Justice (Care and Protection of Children) Act, 2000",2014,0,0,0,0,0,0,0,0,0,0,0,0,0,0,0
D&N Haveli,"47 - Infant Substitutes Regulation Act, 2003",2014,0,0,0,0,0,0,0,0,0,0,0,0,0,0,0
D&N Haveli,"48 - Anti-Hijacking Act, 1982",2014,0,0,0,0,0,0,0,0,0,0,0,0,0,0,0
D&N Haveli,"49 - Atomic Energy Act, 1962",2014,0,0,0,0,0,0,0,0,0,0,0,0,0,0,0
D&N Haveli,"50 - Weapons of Mass Destruction (Proh. of Unlawful Activities) Act, 2005",2014,0,0,0,0,0,0,0,0,0,0,0,0,0,0,0
D&N Haveli,"51 - Suppression of Unlawful Acts against Safety of Civil Aviation Act, 1982",2014,0,0,0,0,0,0,0,0,0,0,0,0,0,0,0
D&N Haveli,"52 - Safety of Maritime Navigation Act, 2002",2014,0,0,0,0,0,0,0,0,0,0,0,0,0,0,0
D&N Haveli,"53 - Manual Scavengers and Construction of Dry Latrines (P) Act, 1993",2014,0,0,0,0,0,0,0,0,0,0,0,0,0,0,0
D&N Haveli,"54 - Pre-Natal Diagnostic Techniques (Reg and Prev of Misuse) Act, 1994",2014,0,0,0,0,0,0,0,0,0,0,0,0,0,0,0
D&N Haveli,"55 - The Maritime Zones of India (Reg of Fishing by Foreign Vessels) Act, 1981",2014,0,0,0,0,0,0,0,0,0,0,0,0,0,0,0
D&N Haveli,56 - Other SLL crimes,2014,0,0,0,1,0,1,0,0,0,0,0,0,1,0,1
D&N Haveli,57 - Total Cognizable SLL crimes,2014,17,2,19,22,0,22,4,0,4,0,0,0,43,2,45
Daman & Diu,"1 - Arms Act, 1959",2014,0,0,0,0,0,0,0,0,0,0,0,0,0,0,0
Daman & Diu,"2 - Narcotic Drugs & Psychotropic Substances Act, 1985",2014,3,0,3,1,0,1,0,0,0,0,0,0,4,0,4
Daman & Diu,"3 - Gambling Act, 1867",2014,20,0,20,24,0,24,17,0,17,2,0,2,63,0,63
Daman & Diu,"4 - Excise Act, 1944",2014,0,0,0,0,0,0,0,0,0,0,0,0,0,0,0
Daman & Diu,5 - Prohibition Act,2014,0,0,0,0,0,0,0,0,0,0,0,0,0,0,0
Daman & Diu,6 - Explosives and Explosive Substances Act,2014,0,0,0,0,0,0,0,0,0,0,0,0,0,0,0
Daman & Diu,"7 - Immoral Traffic (Prevention) Act, 1956",2014,17,19,36,10,0,10,3,0,3,0,0,0,30,19,49
Daman & Diu,7.1 - Under Section 5,2014,17,19,36,10,0,10,3,0,3,0,0,0,30,19,49
Daman & Diu,7.2 - Under Section 6,2014,0,0,0,0,0,0,0,0,0,0,0,0,0,0,0
Daman & Diu,7.3 - Under Section 7,2014,0,0,0,0,0,0,0,0,0,0,0,0,0,0,0
Daman & Diu,7.4 - Under Section 8,2014,0,0,0,0,0,0,0,0,0,0,0,0,0,0,0
Daman & Diu,7.5 - Other Sections under ITP Act,2014,0,0,0,0,0,0,0,0,0,0,0,0,0,0,0
Daman & Diu,"8 - Indian Railways Act, 1989",2014,0,0,0,0,0,0,0,0,0,0,0,0,0,0,0
Daman & Diu,"9 - Registration of Foreigners Act, 1939",2014,0,0,0,0,0,0,0,0,0,0,0,0,0,0,0
Daman & Diu,"10 - Protection of Civil Rights Act, 1955",2014,0,0,0,0,0,0,0,0,0,0,0,0,0,0,0
Daman & Diu,10.1 - PCR Act for crimes committed against SCs,2014,0,0,0,0,0,0,0,0,0,0,0,0,0,0,0
Daman & Diu,10.2 - PCR Act for crimes committed against STs,2014,0,0,0,0,0,0,0,0,0,0,0,0,0,0,0
Daman & Diu,10.3 - PCR Act for crimes committed against Others,2014,0,0,0,0,0,0,0,0,0,0,0,0,0,0,0
Daman & Diu,"11 - Passport Act, 1967",2014,0,0,0,0,0,0,0,0,0,0,0,0,0,0,0
Daman & Diu,"12 - Essential Commodities Act, 1955",2014,0,0,0,1,0,1,0,0,0,0,0,0,1,0,1
Daman & Diu,"13 - Antiquities & Art Treasures Act, 1972",2014,0,0,0,0,0,0,0,0,0,0,0,0,0,0,0
Daman & Diu,"14 - Dowry Prohibition Act, 1961",2014,0,0,0,0,0,0,0,0,0,0,0,0,0,0,0
Daman & Diu,"15 - Indecent Representation of Women (Prohibition) Act, 1986",2014,0,0,0,0,0,0,0,0,0,0,0,0,0,0,0
Daman & Diu,"16 - Copyright Act, 1957",2014,0,0,0,0,0,0,1,0,1,0,0,0,1,0,1
Daman & Diu,17 - Commission of Sati Prevention Act 1987,2014,0,0,0,0,0,0,0,0,0,0,0,0,0,0,0
Daman & Diu,"18 - SC/ST (Prevention of Atrocities) Act, 1989)",2014,0,0,0,0,0,0,0,0,0,0,0,0,0,0,0
Daman & Diu,18.1 - POA Act for crimes committed against SCs,2014,0,0,0,0,0,0,0,0,0,0,0,0,0,0,0
Daman & Diu,18.2 - POA Act for crimes committed against STs,2014,0,0,0,0,0,0,0,0,0,0,0,0,0,0,0
Daman & Diu,"19 - Forest Act, 1927",2014,0,0,0,0,0,0,0,0,0,0,0,0,0,0,0
Daman & Diu,"20 - Prohibition of Child Marriage Act, 2006",2014,0,0,0,0,0,0,0,0,0,0,0,0,0,0,0
Daman & Diu,"21 - Protection of Women from Domestic Violence Act, 2005",2014,0,0,0,0,0,0,0,0,0,0,0,0,0,0,0
Daman & Diu,"22 - Information Technology Act, 2000",2014,2,0,2,0,0,0,0,0,0,0,0,0,2,0,2
Daman & Diu,"23 - Official Secrets Act, 1923",2014,0,0,0,0,0,0,0,0,0,0,0,0,0,0,0
Daman & Diu,"24 - Electricity Act, 2003",2014,0,0,0,0,0,0,0,0,0,0,0,0,0,0,0
Daman & Diu,"25 - Wildlife Protection Act, 1972",2014,0,0,0,0,0,0,0,0,0,0,0,0,0,0,0
Daman & Diu,"26 - Bonded Labour System (Abolition) Act, 1976",2014,0,0,0,0,0,0,0,0,0,0,0,0,0,0,0
Daman & Diu,26.1 - Against SCs,2014,0,0,0,0,0,0,0,0,0,0,0,0,0,0,0
Daman & Diu,26.2 - Against STs,2014,0,0,0,0,0,0,0,0,0,0,0,0,0,0,0
Daman & Diu,26.3 - Against others,2014,0,0,0,0,0,0,0,0,0,0,0,0,0,0,0
Daman & Diu,"27 - Environmental (Protection) Act, 1986",2014,0,0,0,0,0,0,0,0,0,0,0,0,0,0,0
Daman & Diu,"28 - Air (Prevention & Control of Pollution) Act, 1981",2014,0,0,0,0,0,0,0,0,0,0,0,0,0,0,0
Daman & Diu,"29 - Water (Prevention & Control of Pollution) Act, 1974(as amended in 1988)",2014,0,0,0,0,0,0,0,0,0,0,0,0,0,0,0
Daman & Diu,"30 - National Security Act, 1980",2014,0,0,0,0,0,0,0,0,0,0,0,0,0,0,0
Daman & Diu,"31 - Unlawful Activities (Prevention) Act, 1967",2014,0,0,0,0,0,0,0,0,0,0,0,0,0,0,0
Daman & Diu,"32 - Young Persons (Harmful Publications) Act, 1956",2014,0,0,0,0,0,0,0,0,0,0,0,0,0,0,0
Daman & Diu,"33 - Railway Property (Unlawful Possession) Act, 1966",2014,0,0,0,0,0,0,0,0,0,0,0,0,0,0,0
Daman & Diu,"34 - Prevention of Damage to Public Property Act, 1984",2014,0,0,0,0,0,0,0,0,0,0,0,0,0,0,0
Daman & Diu,"35 - Transplantation of Human Organs Act, 1994",2014,0,0,0,0,0,0,0,0,0,0,0,0,0,0,0
Daman & Diu,"36 - Trade Marks Act, 1999",2014,0,0,0,0,0,0,0,0,0,0,0,0,0,0,0
Daman & Diu,"37 - Prevention of Insults to National Honour Act, 1971",2014,0,0,0,0,0,0,0,0,0,0,0,0,0,0,0
Daman & Diu,"38 - State Emblem (Prohibition of Improper Use) Act, 2005",2014,0,0,0,0,0,0,0,0,0,0,0,0,0,0,0
Daman & Diu,"39 - Lotteries (Regulation) Act, 1998",2014,0,0,0,0,0,0,0,0,0,0,0,0,0,0,0
Daman & Diu,"40 - Citizenship Act, 1955",2014,0,0,0,0,0,0,0,0,0,0,0,0,0,0,0
Daman & Diu,"41 - Foreigners Act, 1946",2014,0,0,0,0,0,0,0,0,0,0,0,0,0,0,0
Daman & Diu,"42 - Place of Worship (Special Provisions) Act, 1991",2014,0,0,0,0,0,0,0,0,0,0,0,0,0,0,0
Daman & Diu,"43 - Religious Institution (Prevention of Misuse) Act, 1988",2014,0,0,0,0,0,0,0,0,0,0,0,0,0,0,0
Daman & Diu,"44 - Representation of People Act, 1951",2014,0,0,0,0,0,0,0,0,0,0,0,0,0,0,0
Daman & Diu,"45 - Emigration Act, 1983",2014,0,0,0,0,0,0,0,0,0,0,0,0,0,0,0
Daman & Diu,"46 - Juvenile Justice (Care and Protection of Children) Act, 2000",2014,0,0,0,0,0,0,0,0,0,0,0,0,0,0,0
Daman & Diu,"47 - Infant Substitutes Regulation Act, 2003",2014,0,0,0,0,0,0,0,0,0,0,0,0,0,0,0
Daman & Diu,"48 - Anti-Hijacking Act, 1982",2014,0,0,0,0,0,0,0,0,0,0,0,0,0,0,0
Daman & Diu,"49 - Atomic Energy Act, 1962",2014,0,0,0,0,0,0,0,0,0,0,0,0,0,0,0
Daman & Diu,"50 - Weapons of Mass Destruction (Proh. of Unlawful Activities) Act, 2005",2014,0,0,0,0,0,0,0,0,0,0,0,0,0,0,0
Daman & Diu,"51 - Suppression of Unlawful Acts against Safety of Civil Aviation Act, 1982",2014,0,0,0,0,0,0,0,0,0,0,0,0,0,0,0
Daman & Diu,"52 - Safety of Maritime Navigation Act, 2002",2014,0,0,0,0,0,0,0,0,0,0,0,0,0,0,0
Daman & Diu,"53 - Manual Scavengers and Construction of Dry Latrines (P) Act, 1993",2014,0,0,0,0,0,0,0,0,0,0,0,0,0,0,0
Daman & Diu,"54 - Pre-Natal Diagnostic Techniques (Reg and Prev of Misuse) Act, 1994",2014,0,0,0,0,0,0,0,0,0,0,0,0,0,0,0
Daman & Diu,"55 - The Maritime Zones of India (Reg of Fishing by Foreign Vessels) Act, 1981",2014,0,0,0,0,0,0,0,0,0,0,0,0,0,0,0
Daman & Diu,56 - Other SLL crimes,2014,0,0,0,0,0,0,0,0,0,0,0,0,0,0,0
Daman & Diu,57 - Total Cognizable SLL crimes,2014,42,19,61,36,0,36,21,0,21,2,0,2,101,19,120
Delhi UT,"1 - Arms Act, 1959",2014,523,2,525,263,9,272,34,2,36,1,0,1,821,13,834
Delhi UT,"2 - Narcotic Drugs & Psychotropic Substances Act, 1985",2014,199,6,205,156,6,162,31,0,31,2,0,2,388,12,400
Delhi UT,"3 - Gambling Act, 1867",2014,1140,0,1140,682,0,682,130,0,130,1,0,1,1953,0,1953
Delhi UT,"4 - Excise Act, 1944",2014,693,10,703,529,57,586,130,37,167,2,0,2,1354,104,1458
Delhi UT,5 - Prohibition Act,2014,0,0,0,0,0,0,0,0,0,0,0,0,0,0,0
Delhi UT,6 - Explosives and Explosive Substances Act,2014,5,0,5,1,0,1,0,0,0,0,0,0,6,0,6
Delhi UT,"7 - Immoral Traffic (Prevention) Act, 1956",2014,8,6,14,9,3,12,0,0,0,0,0,0,17,9,26
Delhi UT,7.1 - Under Section 5,2014,8,6,14,6,0,6,0,0,0,0,0,0,14,6,20
Delhi UT,7.2 - Under Section 6,2014,0,0,0,0,0,0,0,0,0,0,0,0,0,0,0
Delhi UT,7.3 - Under Section 7,2014,0,0,0,0,0,0,0,0,0,0,0,0,0,0,0
Delhi UT,7.4 - Under Section 8,2014,0,0,0,1,0,1,0,0,0,0,0,0,1,0,1
Delhi UT,7.5 - Other Sections under ITP Act,2014,0,0,0,2,3,5,0,0,0,0,0,0,2,3,5
Delhi UT,"8 - Indian Railways Act, 1989",2014,0,0,0,0,0,0,0,0,0,0,0,0,0,0,0
Delhi UT,"9 - Registration of Foreigners Act, 1939",2014,0,0,0,1,0,1,0,0,0,0,0,0,1,0,1
Delhi UT,"10 - Protection of Civil Rights Act, 1955",2014,0,0,0,0,0,0,0,0,0,0,0,0,0,0,0
Delhi UT,10.1 - PCR Act for crimes committed against SCs,2014,0,0,0,0,0,0,0,0,0,0,0,0,0,0,0
Delhi UT,10.2 - PCR Act for crimes committed against STs,2014,0,0,0,0,0,0,0,0,0,0,0,0,0,0,0
Delhi UT,10.3 - PCR Act for crimes committed against Others,2014,0,0,0,0,0,0,0,0,0,0,0,0,0,0,0
Delhi UT,"11 - Passport Act, 1967",2014,0,0,0,1,0,1,0,0,0,0,0,0,1,0,1
Delhi UT,"12 - Essential Commodities Act, 1955",2014,20,0,20,40,1,41,7,0,7,0,0,0,67,1,68
Delhi UT,"13 - Antiquities & Art Treasures Act, 1972",2014,0,0,0,2,0,2,0,0,0,0,0,0,2,0,2
Delhi UT,"14 - Dowry Prohibition Act, 1961",2014,1,0,1,2,0,2,0,0,0,0,0,0,3,0,3
Delhi UT,"15 - Indecent Representation of Women (Prohibition) Act, 1986",2014,0,0,0,0,0,0,0,0,0,0,0,0,0,0,0
Delhi UT,"16 - Copyright Act, 1957",2014,13,1,14,108,0,108,9,0,9,1,0,1,131,1,132
Delhi UT,17 - Commission of Sati Prevention Act 1987,2014,0,0,0,0,0,0,0,0,0,0,0,0,0,0,0
Delhi UT,"18 - SC/ST (Prevention of Atrocities) Act, 1989)",2014,21,1,22,26,1,27,9,0,9,0,0,0,56,2,58
Delhi UT,18.1 - POA Act for crimes committed against SCs,2014,21,1,22,25,1,26,9,0,9,0,0,0,55,2,57
Delhi UT,18.2 - POA Act for crimes committed against STs,2014,0,0,0,1,0,1,0,0,0,0,0,0,1,0,1
Delhi UT,"19 - Forest Act, 1927",2014,4,0,4,18,0,18,10,0,10,0,0,0,32,0,32
Delhi UT,"20 - Prohibition of Child Marriage Act, 2006",2014,0,0,0,0,0,0,1,0,1,0,0,0,1,0,1
Delhi UT,"21 - Protection of Women from Domestic Violence Act, 2005",2014,0,0,0,0,0,0,0,0,0,0,0,0,0,0,0
Delhi UT,"22 - Information Technology Act, 2000",2014,13,0,13,17,0,17,5,0,5,0,0,0,35,0,35
Delhi UT,"23 - Official Secrets Act, 1923",2014,0,0,0,0,0,0,0,0,0,0,0,0,0,0,0
Delhi UT,"24 - Electricity Act, 2003",2014,58,0,58,175,2,177,60,0,60,2,0,2,295,2,297
Delhi UT,"25 - Wildlife Protection Act, 1972",2014,0,0,0,8,0,8,1,0,1,0,0,0,9,0,9
Delhi UT,"26 - Bonded Labour System (Abolition) Act, 1976",2014,0,0,0,1,0,1,0,0,0,0,0,0,1,0,1
Delhi UT,26.1 - Against SCs,2014,0,0,0,0,0,0,0,0,0,0,0,0,0,0,0
Delhi UT,26.2 - Against STs,2014,0,0,0,0,0,0,0,0,0,0,0,0,0,0,0
Delhi UT,26.3 - Against others,2014,0,0,0,1,0,1,0,0,0,0,0,0,1,0,1
Delhi UT,"27 - Environmental (Protection) Act, 1986",2014,0,0,0,0,0,0,0,0,0,0,0,0,0,0,0
Delhi UT,"28 - Air (Prevention & Control of Pollution) Act, 1981",2014,0,0,0,0,0,0,0,0,0,0,0,0,0,0,0
Delhi UT,"29 - Water (Prevention & Control of Pollution) Act, 1974(as amended in 1988)",2014,0,0,0,0,0,0,0,0,0,0,0,0,0,0,0
Delhi UT,"30 - National Security Act, 1980",2014,0,0,0,0,0,0,0,0,0,0,0,0,0,0,0
Delhi UT,"31 - Unlawful Activities (Prevention) Act, 1967",2014,1,0,1,0,0,0,0,0,0,0,0,0,1,0,1
Delhi UT,"32 - Young Persons (Harmful Publications) Act, 1956",2014,0,0,0,0,0,0,0,0,0,0,0,0,0,0,0
Delhi UT,"33 - Railway Property (Unlawful Possession) Act, 1966",2014,0,0,0,0,0,0,0,0,0,0,0,0,0,0,0
Delhi UT,"34 - Prevention of Damage to Public Property Act, 1984",2014,1,0,1,0,0,0,0,0,0,0,0,0,1,0,1
Delhi UT,"35 - Transplantation of Human Organs Act, 1994",2014,0,0,0,0,0,0,0,0,0,0,0,0,0,0,0
Delhi UT,"36 - Trade Marks Act, 1999",2014,3,0,3,14,0,14,15,4,19,4,0,4,36,4,40
Delhi UT,"37 - Prevention of Insults to National Honour Act, 1971",2014,0,0,0,0,0,0,0,0,0,0,0,0,0,0,0
Delhi UT,"38 - State Emblem (Prohibition of Improper Use) Act, 2005",2014,0,0,0,0,0,0,0,0,0,0,0,0,0,0,0
Delhi UT,"39 - Lotteries (Regulation) Act, 1998",2014,0,0,0,0,0,0,0,0,0,0,0,0,0,0,0
Delhi UT,"40 - Citizenship Act, 1955",2014,0,0,0,0,0,0,0,0,0,0,0,0,0,0,0
Delhi UT,"41 - Foreigners Act, 1946",2014,1,0,1,6,0,6,0,0,0,0,0,0,7,0,7
Delhi UT,"42 - Place of Worship (Special Provisions) Act, 1991",2014,0,0,0,0,0,0,0,0,0,0,0,0,0,0,0
Delhi UT,"43 - Religious Institution (Prevention of Misuse) Act, 1988",2014,0,0,0,0,0,0,0,0,0,0,0,0,0,0,0
Delhi UT,"44 - Representation of People Act, 1951",2014,0,0,0,0,0,0,0,0,0,0,0,0,0,0,0
Delhi UT,"45 - Emigration Act, 1983",2014,0,0,0,0,0,0,0,0,0,0,0,0,0,0,0
Delhi UT,"46 - Juvenile Justice (Care and Protection of Children) Act, 2000",2014,12,1,13,65,3,68,17,3,20,0,0,0,94,7,101
Delhi UT,"47 - Infant Substitutes Regulation Act, 2003",2014,0,0,0,0,0,0,0,0,0,0,0,0,0,0,0
Delhi UT,"48 - Anti-Hijacking Act, 1982",2014,0,0,0,0,0,0,0,0,0,0,0,0,0,0,0
Delhi UT,"49 - Atomic Energy Act, 1962",2014,0,0,0,0,0,0,0,0,0,0,0,0,0,0,0
Delhi UT,"50 - Weapons of Mass Destruction (Proh. of Unlawful Activities) Act, 2005",2014,0,0,0,0,0,0,0,0,0,0,0,0,0,0,0
Delhi UT,"51 - Suppression of Unlawful Acts against Safety of Civil Aviation Act, 1982",2014,0,0,0,0,0,0,0,0,0,0,0,0,0,0,0
Delhi UT,"52 - Safety of Maritime Navigation Act, 2002",2014,0,0,0,0,0,0,0,0,0,0,0,0,0,0,0
Delhi UT,"53 - Manual Scavengers and Construction of Dry Latrines (P) Act, 1993",2014,0,0,0,0,0,0,0,0,0,0,0,0,0,0,0
Delhi UT,"54 - Pre-Natal Diagnostic Techniques (Reg and Prev of Misuse) Act, 1994",2014,0,0,0,0,0,0,0,0,0,0,0,0,0,0,0
Delhi UT,"55 - The Maritime Zones of India (Reg of Fishing by Foreign Vessels) Act, 1981",2014,0,0,0,0,0,0,0,0,0,0,0,0,0,0,0
Delhi UT,56 - Other SLL crimes,2014,1327,10,1337,1042,27,1069,195,5,200,14,0,14,2578,42,2620
Delhi UT,57 - Total Cognizable SLL crimes,2014,4043,37,4080,3166,109,3275,654,51,705,27,0,27,7890,197,8087
Lakshadweep,"1 - Arms Act, 1959",2014,0,0,0,0,0,0,0,0,0,0,0,0,0,0,0
Lakshadweep,"2 - Narcotic Drugs & Psychotropic Substances Act, 1985",2014,12,0,12,16,1,17,0,0,0,0,0,0,28,1,29
Lakshadweep,"3 - Gambling Act, 1867",2014,0,0,0,0,0,0,0,0,0,0,0,0,0,0,0
Lakshadweep,"4 - Excise Act, 1944",2014,0,0,0,0,0,0,0,0,0,0,0,0,0,0,0
Lakshadweep,5 - Prohibition Act,2014,4,0,4,10,0,10,2,0,2,0,0,0,16,0,16
Lakshadweep,6 - Explosives and Explosive Substances Act,2014,0,0,0,0,0,0,0,0,0,0,0,0,0,0,0
Lakshadweep,"7 - Immoral Traffic (Prevention) Act, 1956",2014,0,0,0,0,0,0,0,0,0,0,0,0,0,0,0
Lakshadweep,7.1 - Under Section 5,2014,0,0,0,0,0,0,0,0,0,0,0,0,0,0,0
Lakshadweep,7.2 - Under Section 6,2014,0,0,0,0,0,0,0,0,0,0,0,0,0,0,0
Lakshadweep,7.3 - Under Section 7,2014,0,0,0,0,0,0,0,0,0,0,0,0,0,0,0
Lakshadweep,7.4 - Under Section 8,2014,0,0,0,0,0,0,0,0,0,0,0,0,0,0,0
Lakshadweep,7.5 - Other Sections under ITP Act,2014,0,0,0,0,0,0,0,0,0,0,0,0,0,0,0
Lakshadweep,"8 - Indian Railways Act, 1989",2014,0,0,0,0,0,0,0,0,0,0,0,0,0,0,0
Lakshadweep,"9 - Registration of Foreigners Act, 1939",2014,0,0,0,0,0,0,0,0,0,0,0,0,0,0,0
Lakshadweep,"10 - Protection of Civil Rights Act, 1955",2014,0,0,0,0,0,0,0,0,0,0,0,0,0,0,0
Lakshadweep,10.1 - PCR Act for crimes committed against SCs,2014,0,0,0,0,0,0,0,0,0,0,0,0,0,0,0
Lakshadweep,10.2 - PCR Act for crimes committed against STs,2014,0,0,0,0,0,0,0,0,0,0,0,0,0,0,0
Lakshadweep,10.3 - PCR Act for crimes committed against Others,2014,0,0,0,0,0,0,0,0,0,0,0,0,0,0,0
Lakshadweep,"11 - Passport Act, 1967",2014,0,0,0,0,0,0,0,0,0,0,0,0,0,0,0
Lakshadweep,"12 - Essential Commodities Act, 1955",2014,0,0,0,0,0,0,0,0,0,0,0,0,0,0,0
Lakshadweep,"13 - Antiquities & Art Treasures Act, 1972",2014,0,0,0,0,0,0,0,0,0,0,0,0,0,0,0
Lakshadweep,"14 - Dowry Prohibition Act, 1961",2014,0,0,0,0,0,0,0,0,0,0,0,0,0,0,0
Lakshadweep,"15 - Indecent Representation of Women (Prohibition) Act, 1986",2014,0,0,0,0,0,0,0,0,0,0,0,0,0,0,0
Lakshadweep,"16 - Copyright Act, 1957",2014,0,0,0,0,0,0,0,0,0,0,0,0,0,0,0
Lakshadweep,17 - Commission of Sati Prevention Act 1987,2014,0,0,0,0,0,0,0,0,0,0,0,0,0,0,0
Lakshadweep,"18 - SC/ST (Prevention of Atrocities) Act, 1989)",2014,0,0,0,0,0,0,0,0,0,0,0,0,0,0,0
Lakshadweep,18.1 - POA Act for crimes committed against SCs,2014,0,0,0,0,0,0,0,0,0,0,0,0,0,0,0
Lakshadweep,18.2 - POA Act for crimes committed against STs,2014,0,0,0,0,0,0,0,0,0,0,0,0,0,0,0
Lakshadweep,"19 - Forest Act, 1927",2014,0,0,0,0,0,0,0,0,0,0,0,0,0,0,0
Lakshadweep,"20 - Prohibition of Child Marriage Act, 2006",2014,0,0,0,0,0,0,0,0,0,0,0,0,0,0,0
Lakshadweep,"21 - Protection of Women from Domestic Violence Act, 2005",2014,0,0,0,0,0,0,0,0,0,0,0,0,0,0,0
Lakshadweep,"22 - Information Technology Act, 2000",2014,0,0,0,0,0,0,0,0,0,0,0,0,0,0,0
Lakshadweep,"23 - Official Secrets Act, 1923",2014,0,0,0,0,0,0,0,0,0,0,0,0,0,0,0
Lakshadweep,"24 - Electricity Act, 2003",2014,0,0,0,0,0,0,0,0,0,0,0,0,0,0,0
Lakshadweep,"25 - Wildlife Protection Act, 1972",2014,0,0,0,0,0,0,0,0,0,0,0,0,0,0,0
Lakshadweep,"26 - Bonded Labour System (Abolition) Act, 1976",2014,0,0,0,0,0,0,0,0,0,0,0,0,0,0,0
Lakshadweep,26.1 - Against SCs,2014,0,0,0,0,0,0,0,0,0,0,0,0,0,0,0
Lakshadweep,26.2 - Against STs,2014,0,0,0,0,0,0,0,0,0,0,0,0,0,0,0
Lakshadweep,26.3 - Against others,2014,0,0,0,0,0,0,0,0,0,0,0,0,0,0,0
Lakshadweep,"27 - Environmental (Protection) Act, 1986",2014,0,0,0,0,0,0,0,0,0,0,0,0,0,0,0
Lakshadweep,"28 - Air (Prevention & Control of Pollution) Act, 1981",2014,0,0,0,0,0,0,0,0,0,0,0,0,0,0,0
Lakshadweep,"29 - Water (Prevention & Control of Pollution) Act, 1974(as amended in 1988)",2014,0,0,0,0,0,0,0,0,0,0,0,0,0,0,0
Lakshadweep,"30 - National Security Act, 1980",2014,0,0,0,0,0,0,0,0,0,0,0,0,0,0,0
Lakshadweep,"31 - Unlawful Activities (Prevention) Act, 1967",2014,0,0,0,0,0,0,0,0,0,0,0,0,0,0,0
Lakshadweep,"32 - Young Persons (Harmful Publications) Act, 1956",2014,0,0,0,0,0,0,0,0,0,0,0,0,0,0,0
Lakshadweep,"33 - Railway Property (Unlawful Possession) Act, 1966",2014,0,0,0,0,0,0,0,0,0,0,0,0,0,0,0
Lakshadweep,"34 - Prevention of Damage to Public Property Act, 1984",2014,0,0,0,0,0,0,0,0,0,0,0,0,0,0,0
Lakshadweep,"35 - Transplantation of Human Organs Act, 1994",2014,0,0,0,0,0,0,0,0,0,0,0,0,0,0,0
Lakshadweep,"36 - Trade Marks Act, 1999",2014,0,0,0,0,0,0,0,0,0,0,0,0,0,0,0
Lakshadweep,"37 - Prevention of Insults to National Honour Act, 1971",2014,0,0,0,0,0,0,0,0,0,0,0,0,0,0,0
Lakshadweep,"38 - State Emblem (Prohibition of Improper Use) Act, 2005",2014,0,0,0,0,0,0,0,0,0,0,0,0,0,0,0
Lakshadweep,"39 - Lotteries (Regulation) Act, 1998",2014,0,0,0,0,0,0,0,0,0,0,0,0,0,0,0
Lakshadweep,"40 - Citizenship Act, 1955",2014,0,0,0,0,0,0,0,0,0,0,0,0,0,0,0
Lakshadweep,"41 - Foreigners Act, 1946",2014,0,0,0,0,0,0,0,0,0,0,0,0,0,0,0
Lakshadweep,"42 - Place of Worship (Special Provisions) Act, 1991",2014,0,0,0,0,0,0,0,0,0,0,0,0,0,0,0
Lakshadweep,"43 - Religious Institution (Prevention of Misuse) Act, 1988",2014,0,0,0,0,0,0,0,0,0,0,0,0,0,0,0
Lakshadweep,"44 - Representation of People Act, 1951",2014,0,0,0,0,0,0,0,0,0,0,0,0,0,0,0
Lakshadweep,"45 - Emigration Act, 1983",2014,0,0,0,0,0,0,0,0,0,0,0,0,0,0,0
Lakshadweep,"46 - Juvenile Justice (Care and Protection of Children) Act, 2000",2014,0,0,0,0,0,0,0,0,0,0,0,0,0,0,0
Lakshadweep,"47 - Infant Substitutes Regulation Act, 2003",2014,0,0,0,0,0,0,0,0,0,0,0,0,0,0,0
Lakshadweep,"48 - Anti-Hijacking Act, 1982",2014,0,0,0,0,0,0,0,0,0,0,0,0,0,0,0
Lakshadweep,"49 - Atomic Energy Act, 1962",2014,0,0,0,0,0,0,0,0,0,0,0,0,0,0,0
Lakshadweep,"50 - Weapons of Mass Destruction (Proh. of Unlawful Activities) Act, 2005",2014,0,0,0,0,0,0,0,0,0,0,0,0,0,0,0
Lakshadweep,"51 - Suppression of Unlawful Acts against Safety of Civil Aviation Act, 1982",2014,0,0,0,0,0,0,0,0,0,0,0,0,0,0,0
Lakshadweep,"52 - Safety of Maritime Navigation Act, 2002",2014,0,0,0,0,0,0,0,0,0,0,0,0,0,0,0
Lakshadweep,"53 - Manual Scavengers and Construction of Dry Latrines (P) Act, 1993",2014,0,0,0,0,0,0,0,0,0,0,0,0,0,0,0
Lakshadweep,"54 - Pre-Natal Diagnostic Techniques (Reg and Prev of Misuse) Act, 1994",2014,0,0,0,0,0,0,0,0,0,0,0,0,0,0,0
Lakshadweep,"55 - The Maritime Zones of India (Reg of Fishing by Foreign Vessels) Act, 1981",2014,0,0,0,0,0,0,0,0,0,0,0,0,0,0,0
Lakshadweep,56 - Other SLL crimes,2014,3,0,3,17,0,17,0,0,0,1,0,1,21,0,21
Lakshadweep,57 - Total Cognizable SLL crimes,2014,19,0,19,43,1,44,2,0,2,1,0,1,65,1,66
Puducherry,"1 - Arms Act, 1959",2014,54,0,54,8,0,8,1,0,1,0,0,0,63,0,63
Puducherry,"2 - Narcotic Drugs & Psychotropic Substances Act, 1985",2014,0,0,0,0,0,0,1,0,1,0,0,0,1,0,1
Puducherry,"3 - Gambling Act, 1867",2014,34,0,34,68,0,68,11,0,11,2,0,2,115,0,115
Puducherry,"4 - Excise Act, 1944",2014,0,0,0,0,0,0,0,0,0,0,0,0,0,0,0
Puducherry,5 - Prohibition Act,2014,0,0,0,0,0,0,0,0,0,0,0,0,0,0,0
Puducherry,6 - Explosives and Explosive Substances Act,2014,0,0,0,1,0,1,0,0,0,0,0,0,1,0,1
Puducherry,"7 - Immoral Traffic (Prevention) Act, 1956",2014,0,0,0,3,1,4,0,0,0,0,0,0,3,1,4
Puducherry,7.1 - Under Section 5,2014,0,0,0,1,0,1,0,0,0,0,0,0,1,0,1
Puducherry,7.2 - Under Section 6,2014,0,0,0,2,1,3,0,0,0,0,0,0,2,1,3
Puducherry,7.3 - Under Section 7,2014,0,0,0,0,0,0,0,0,0,0,0,0,0,0,0
Puducherry,7.4 - Under Section 8,2014,0,0,0,0,0,0,0,0,0,0,0,0,0,0,0
Puducherry,7.5 - Other Sections under ITP Act,2014,0,0,0,0,0,0,0,0,0,0,0,0,0,0,0
Puducherry,"8 - Indian Railways Act, 1989",2014,0,0,0,0,0,0,0,0,0,0,0,0,0,0,0
Puducherry,"9 - Registration of Foreigners Act, 1939",2014,0,0,0,0,0,0,0,0,0,0,0,0,0,0,0
Puducherry,"10 - Protection of Civil Rights Act, 1955",2014,0,0,0,5,0,5,0,0,0,0,0,0,5,0,5
Puducherry,10.1 - PCR Act for crimes committed against SCs,2014,0,0,0,5,0,5,0,0,0,0,0,0,5,0,5
Puducherry,10.2 - PCR Act for crimes committed against STs,2014,0,0,0,0,0,0,0,0,0,0,0,0,0,0,0
Puducherry,10.3 - PCR Act for crimes committed against Others,2014,0,0,0,0,0,0,0,0,0,0,0,0,0,0,0
Puducherry,"11 - Passport Act, 1967",2014,0,0,0,0,0,0,0,0,0,0,0,0,0,0,0
Puducherry,"12 - Essential Commodities Act, 1955",2014,21,0,21,10,0,10,3,0,3,0,0,0,34,0,34
Puducherry,"13 - Antiquities & Art Treasures Act, 1972",2014,0,0,0,0,0,0,0,0,0,0,0,0,0,0,0
Puducherry,"14 - Dowry Prohibition Act, 1961",2014,6,0,6,3,0,3,0,0,0,0,0,0,9,0,9
Puducherry,"15 - Indecent Representation of Women (Prohibition) Act, 1986",2014,0,0,0,0,0,0,0,0,0,0,0,0,0,0,0
Puducherry,"16 - Copyright Act, 1957",2014,0,0,0,0,0,0,0,0,0,0,0,0,0,0,0
Puducherry,17 - Commission of Sati Prevention Act 1987,2014,0,0,0,0,0,0,0,0,0,0,0,0,0,0,0
Puducherry,"18 - SC/ST (Prevention of Atrocities) Act, 1989)",2014,0,0,0,0,0,0,0,0,0,0,0,0,0,0,0
Puducherry,18.1 - POA Act for crimes committed against SCs,2014,0,0,0,0,0,0,0,0,0,0,0,0,0,0,0
Puducherry,18.2 - POA Act for crimes committed against STs,2014,0,0,0,0,0,0,0,0,0,0,0,0,0,0,0
Puducherry,"19 - Forest Act, 1927",2014,0,0,0,0,0,0,0,0,0,0,0,0,0,0,0
Puducherry,"20 - Prohibition of Child Marriage Act, 2006",2014,2,0,2,4,4,8,0,0,0,0,0,0,6,4,10
Puducherry,"21 - Protection of Women from Domestic Violence Act, 2005",2014,0,0,0,0,0,0,0,0,0,0,0,0,0,0,0
Puducherry,"22 - Information Technology Act, 2000",2014,0,0,0,0,0,0,0,0,0,0,0,0,0,0,0
Puducherry,"23 - Official Secrets Act, 1923",2014,0,0,0,0,0,0,0,0,0,0,0,0,0,0,0
Puducherry,"24 - Electricity Act, 2003",2014,0,0,0,0,0,0,0,0,0,0,0,0,0,0,0
Puducherry,"25 - Wildlife Protection Act, 1972",2014,0,0,0,1,0,1,0,0,0,0,0,0,1,0,1
Puducherry,"26 - Bonded Labour System (Abolition) Act, 1976",2014,0,0,0,0,0,0,0,0,0,0,0,0,0,0,0
Puducherry,26.1 - Against SCs,2014,0,0,0,0,0,0,0,0,0,0,0,0,0,0,0
Puducherry,26.2 - Against STs,2014,0,0,0,0,0,0,0,0,0,0,0,0,0,0,0
Puducherry,26.3 - Against others,2014,0,0,0,0,0,0,0,0,0,0,0,0,0,0,0
Puducherry,"27 - Environmental (Protection) Act, 1986",2014,0,0,0,0,0,0,0,0,0,0,0,0,0,0,0
Puducherry,"28 - Air (Prevention & Control of Pollution) Act, 1981",2014,0,0,0,0,0,0,0,0,0,0,0,0,0,0,0
Puducherry,"29 - Water (Prevention & Control of Pollution) Act, 1974(as amended in 1988)",2014,0,0,0,0,0,0,0,0,0,0,0,0,0,0,0
Puducherry,"30 - National Security Act, 1980",2014,0,0,0,0,0,0,0,0,0,0,0,0,0,0,0
Puducherry,"31 - Unlawful Activities (Prevention) Act, 1967",2014,0,0,0,0,0,0,0,0,0,0,0,0,0,0,0
Puducherry,"32 - Young Persons (Harmful Publications) Act, 1956",2014,0,0,0,0,0,0,0,0,0,0,0,0,0,0,0
Puducherry,"33 - Railway Property (Unlawful Possession) Act, 1966",2014,0,0,0,0,0,0,0,0,0,0,0,0,0,0,0
Puducherry,"34 - Prevention of Damage to Public Property Act, 1984",2014,4,0,4,6,0,6,2,0,2,0,0,0,12,0,12
Puducherry,"35 - Transplantation of Human Organs Act, 1994",2014,0,0,0,0,0,0,0,0,0,0,0,0,0,0,0
Puducherry,"36 - Trade Marks Act, 1999",2014,0,0,0,0,0,0,0,0,0,0,0,0,0,0,0
Puducherry,"37 - Prevention of Insults to National Honour Act, 1971",2014,0,0,0,0,0,0,0,0,0,0,0,0,0,0,0
Puducherry,"38 - State Emblem (Prohibition of Improper Use) Act, 2005",2014,0,0,0,0,0,0,0,0,0,0,0,0,0,0,0
Puducherry,"39 - Lotteries (Regulation) Act, 1998",2014,2,0,2,8,0,8,7,0,7,1,0,1,18,0,18
Puducherry,"40 - Citizenship Act, 1955",2014,0,0,0,0,0,0,0,0,0,0,0,0,0,0,0
Puducherry,"41 - Foreigners Act, 1946",2014,0,0,0,0,0,0,0,0,0,0,0,0,0,0,0
Puducherry,"42 - Place of Worship (Special Provisions) Act, 1991",2014,0,0,0,0,0,0,0,0,0,0,0,0,0,0,0
Puducherry,"43 - Religious Institution (Prevention of Misuse) Act, 1988",2014,0,0,0,0,0,0,0,0,0,0,0,0,0,0,0
Puducherry,"44 - Representation of People Act, 1951",2014,1,0,1,6,0,6,5,0,5,0,0,0,12,0,12
Puducherry,"45 - Emigration Act, 1983",2014,0,0,0,0,0,0,0,0,0,0,0,0,0,0,0
Puducherry,"46 - Juvenile Justice (Care and Protection of Children) Act, 2000",2014,0,0,0,0,0,0,0,0,0,0,0,0,0,0,0
Puducherry,"47 - Infant Substitutes Regulation Act, 2003",2014,0,0,0,0,0,0,0,0,0,0,0,0,0,0,0
Puducherry,"48 - Anti-Hijacking Act, 1982",2014,0,0,0,0,0,0,0,0,0,0,0,0,0,0,0
Puducherry,"49 - Atomic Energy Act, 1962",2014,0,0,0,0,0,0,0,0,0,0,0,0,0,0,0
Puducherry,"50 - Weapons of Mass Destruction (Proh. of Unlawful Activities) Act, 2005",2014,0,0,0,0,0,0,0,0,0,0,0,0,0,0,0
Puducherry,"51 - Suppression of Unlawful Acts against Safety of Civil Aviation Act, 1982",2014,0,0,0,0,0,0,0,0,0,0,0,0,0,0,0
Puducherry,"52 - Safety of Maritime Navigation Act, 2002",2014,0,0,0,0,0,0,0,0,0,0,0,0,0,0,0
Puducherry,"53 - Manual Scavengers and Construction of Dry Latrines (P) Act, 1993",2014,0,0,0,0,0,0,0,0,0,0,0,0,0,0,0
Puducherry,"54 - Pre-Natal Diagnostic Techniques (Reg and Prev of Misuse) Act, 1994",2014,0,0,0,0,0,0,0,0,0,0,0,0,0,0,0
Puducherry,"55 - The Maritime Zones of India (Reg of Fishing by Foreign Vessels) Act, 1981",2014,0,0,0,0,0,0,0,0,0,0,0,0,0,0,0
Puducherry,56 - Other SLL crimes,2014,376,0,376,338,0,338,97,4,101,3,0,3,814,4,818
Puducherry,57 - Total Cognizable SLL crimes,2014,500,0,500,461,5,466,127,4,131,6,0,6,1094,9,1103
Total (States),"1 - Arms Act, 1959",2014,35184,12,35196,21465,12,21477,4685,1,4686,219,0,219,61553,25,61578
Total (States),"2 - Narcotic Drugs & Psychotropic Substances Act, 1985",2014,27866,399,28265,19723,745,20468,5899,338,6237,339,34,373,53827,1516,55343
Total (States),"3 - Gambling Act, 1867",2014,146223,192,146415,146339,493,146832,63048,204,63252,5435,17,5452,361045,906,361951
Total (States),"4 - Excise Act, 1944",2014,77273,1961,79234,76762,3784,80546,30396,1664,32060,2007,123,2130,186438,7532,193970
Total (States),5 - Prohibition Act,2014,131583,24621,156204,174570,48995,223565,79483,29148,108631,7921,1727,9648,393557,104491,498048
Total (States),6 - Explosives and Explosive Substances Act,2014,1950,8,1958,2444,17,2461,760,2,762,50,0,50,5204,27,5231
Total (States),"7 - Immoral Traffic (Prevention) Act, 1956",2014,2254,1053,3307,2192,894,3086,548,197,745,27,13,40,5021,2157,7178
Total (States),7.1 - Under Section 5,2014,852,343,1195,729,300,1029,161,62,223,11,2,13,1753,707,2460
Total (States),7.2 - Under Section 6,2014,119,81,200,129,40,169,37,8,45,4,0,4,289,129,418
Total (States),7.3 - Under Section 7,2014,99,41,140,118,44,162,46,12,58,1,1,2,264,98,362
Total (States),7.4 - Under Section 8,2014,34,48,82,67,81,148,10,12,22,0,1,1,111,142,253
Total (States),7.5 - Other Sections under ITP Act,2014,1150,540,1690,1149,429,1578,294,103,397,11,9,20,2604,1081,3685
Total (States),"8 - Indian Railways Act, 1989",2014,84,0,84,142,0,142,28,0,28,0,0,0,254,0,254
Total (States),"9 - Registration of Foreigners Act, 1939",2014,421,36,457,282,17,299,108,5,113,3,0,3,814,58,872
Total (States),"10 - Protection of Civil Rights Act, 1955",2014,59,3,62,78,0,78,26,4,30,5,0,5,168,7,175
Total (States),10.1 - PCR Act for crimes committed against SCs,2014,57,3,60,66,0,66,26,4,30,5,0,5,154,7,161
Total (States),10.2 - PCR Act for crimes committed against STs,2014,1,0,1,0,0,0,0,0,0,0,0,0,1,0,1
Total (States),10.3 - PCR Act for crimes committed against Others,2014,1,0,1,12,0,12,0,0,0,0,0,0,13,0,13
Total (States),"11 - Passport Act, 1967",2014,433,32,465,607,61,668,170,3,173,5,1,6,1215,97,1312
Total (States),"12 - Essential Commodities Act, 1955",2014,2433,10,2443,4061,37,4098,1281,12,1293,88,2,90,7863,61,7924
Total (States),"13 - Antiquities & Art Treasures Act, 1972",2014,18,0,18,45,0,45,25,0,25,1,0,1,89,0,89
Total (States),"14 - Dowry Prohibition Act, 1961",2014,6340,1037,7377,7195,1832,9027,3478,1305,4783,252,80,332,17265,4254,21519
Total (States),"15 - Indecent Representation of Women (Prohibition) Act, 1986",2014,24,0,24,38,1,39,5,0,5,0,0,0,67,1,68
Total (States),"16 - Copyright Act, 1957",2014,2866,3,2869,3273,10,3283,654,0,654,11,0,11,6804,13,6817
Total (States),17 - Commission of Sati Prevention Act 1987,2014,0,0,0,0,0,0,0,0,0,0,0,0,0,0,0
Total (States),"18 - SC/ST (Prevention of Atrocities) Act, 1989)",2014,7881,151,8032,7624,349,7973,3164,135,3299,239,15,254,18908,650,19558
Total (States),18.1 - POA Act for crimes committed against SCs,2014,7047,130,7177,6672,278,6950,2822,119,2941,179,12,191,16720,539,17259
Total (States),18.2 - POA Act for crimes committed against STs,2014,834,21,855,952,71,1023,342,16,358,60,3,63,2188,111,2299
Total (States),"19 - Forest Act, 1927",2014,2479,2,2481,3322,0,3322,1157,1,1158,41,0,41,6999,3,7002
Total (States),"20 - Prohibition of Child Marriage Act, 2006",2014,166,10,176,276,88,364,104,40,144,11,5,16,557,143,700
Total (States),"21 - Protection of Women from Domestic Violence Act, 2005",2014,204,21,225,277,30,307,130,17,147,14,0,14,625,68,693
Total (States),"22 - Information Technology Act, 2000",2014,2262,27,2289,1569,26,1595,267,7,274,4,0,4,4102,60,4162
Total (States),"23 - Official Secrets Act, 1923",2014,3,0,3,7,0,7,3,0,3,0,0,0,13,0,13
Total (States),"24 - Electricity Act, 2003",2014,11827,42,11869,23313,92,23405,12478,69,12547,955,1,956,48573,204,48777
Total (States),"25 - Wildlife Protection Act, 1972",2014,473,3,476,676,7,683,168,4,172,6,0,6,1323,14,1337
Total (States),"26 - Bonded Labour System (Abolition) Act, 1976",2014,42,0,42,53,0,53,17,0,17,0,0,0,112,0,112
Total (States),26.1 - Against SCs,2014,0,0,0,7,0,7,1,0,1,0,0,0,8,0,8
Total (States),26.2 - Against STs,2014,0,0,0,0,0,0,0,0,0,0,0,0,0,0,0
Total (States),26.3 - Against others,2014,42,0,42,46,0,46,16,0,16,0,0,0,104,0,104
Total (States),"27 - Environmental (Protection) Act, 1986",2014,35,0,35,60,1,61,33,0,33,0,0,0,128,1,129
Total (States),"28 - Air (Prevention & Control of Pollution) Act, 1981",2014,34,0,34,56,0,56,27,0,27,6,0,6,123,0,123
Total (States),"29 - Water (Prevention & Control of Pollution) Act, 1974(as amended in 1988)",2014,16,0,16,18,0,18,4,0,4,0,0,0,38,0,38
Total (States),"30 - National Security Act, 1980",2014,161,0,161,165,0,165,13,0,13,0,0,0,339,0,339
Total (States),"31 - Unlawful Activities (Prevention) Act, 1967",2014,1046,23,1069,898,32,930,150,10,160,16,1,17,2110,66,2176
Total (States),"32 - Young Persons (Harmful Publications) Act, 1956",2014,2,0,2,10,0,10,1,0,1,0,0,0,13,0,13
Total (States),"33 - Railway Property (Unlawful Possession) Act, 1966",2014,1,0,1,0,0,0,0,0,0,0,0,0,1,0,1
Total (States),"34 - Prevention of Damage to Public Property Act, 1984",2014,2508,12,2520,2594,35,2629,788,7,795,27,2,29,5917,56,5973
Total (States),"35 - Transplantation of Human Organs Act, 1994",2014,0,0,0,0,0,0,0,0,0,0,0,0,0,0,0
Total (States),"36 - Trade Marks Act, 1999",2014,29,0,29,48,0,48,13,0,13,0,0,0,90,0,90
Total (States),"37 - Prevention of Insults to National Honour Act, 1971",2014,16,0,16,58,3,61,12,1,13,0,0,0,86,4,90
Total (States),"38 - State Emblem (Prohibition of Improper Use) Act, 2005",2014,0,0,0,1,0,1,0,0,0,0,0,0,1,0,1
Total (States),"39 - Lotteries (Regulation) Act, 1998",2014,775,0,775,1227,7,1234,442,1,443,35,0,35,2479,8,2487
Total (States),"40 - Citizenship Act, 1955",2014,8,0,8,6,0,6,3,0,3,0,0,0,17,0,17
Total (States),"41 - Foreigners Act, 1946",2014,1445,95,1540,1552,57,1609,496,51,547,3,0,3,3496,203,3699
Total (States),"42 - Place of Worship (Special Provisions) Act, 1991",2014,6,0,6,2,0,2,0,0,0,0,0,0,8,0,8
Total (States),"43 - Religious Institution (Prevention of Misuse) Act, 1988",2014,0,0,0,1,0,1,1,0,1,0,0,0,2,0,2
Total (States),"44 - Representation of People Act, 1951",2014,210,2,212,392,4,396,169,0,169,11,0,11,782,6,788
Total (States),"45 - Emigration Act, 1983",2014,14,0,14,33,3,36,8,0,8,0,0,0,55,3,58
Total (States),"46 - Juvenile Justice (Care and Protection of Children) Act, 2000",2014,262,12,274,369,29,398,147,22,169,12,1,13,790,64,854
Total (States),"47 - Infant Substitutes Regulation Act, 2003",2014,0,0,0,0,0,0,0,0,0,0,0,0,0,0,0
Total (States),"48 - Anti-Hijacking Act, 1982",2014,0,0,0,0,0,0,0,0,0,0,0,0,0,0,0
Total (States),"49 - Atomic Energy Act, 1962",2014,1,0,1,0,0,0,0,0,0,0,0,0,1,0,1
Total (States),"50 - Weapons of Mass Destruction (Proh. of Unlawful Activities) Act, 2005",2014,0,0,0,0,0,0,0,0,0,0,0,0,0,0,0
Total (States),"51 - Suppression of Unlawful Acts against Safety of Civil Aviation Act, 1982",2014,0,0,0,0,0,0,0,0,0,0,0,0,0,0,0
Total (States),"52 - Safety of Maritime Navigation Act, 2002",2014,0,0,0,0,0,0,0,0,0,0,0,0,0,0,0
Total (States),"53 - Manual Scavengers and Construction of Dry Latrines (P) Act, 1993",2014,0,0,0,0,0,0,0,0,0,0,0,0,0,0,0
Total (States),"54 - Pre-Natal Diagnostic Techniques (Reg and Prev of Misuse) Act, 1994",2014,7,0,7,21,3,24,2,1,3,1,1,2,31,5,36
Total (States),"55 - The Maritime Zones of India (Reg of Fishing by Foreign Vessels) Act, 1981",2014,15,0,15,34,0,34,7,0,7,0,0,0,56,0,56
Total (States),56 - Other SLL crimes,2014,2023422,9107,2032529,1100284,7934,1108218,303417,2766,306183,16144,193,16337,3443267,20000,3463267
Total (States),57 - Total Cognizable SLL crimes,2014,2490361,38874,2529235,1604162,65598,1669760,513815,36015,549830,33888,2216,36104,4642226,142703,4784929
Total (UTs),"1 - Arms Act, 1959",2014,587,2,589,279,9,288,35,2,37,1,0,1,902,13,915
Total (UTs),"2 - Narcotic Drugs & Psychotropic Substances Act, 1985",2014,284,11,295,233,13,246,73,0,73,5,0,5,595,24,619
Total (UTs),"3 - Gambling Act, 1867",2014,1521,0,1521,1232,0,1232,319,0,319,39,0,39,3111,0,3111
Total (UTs),"4 - Excise Act, 1944",2014,1460,44,1504,1662,168,1830,799,109,908,167,31,198,4088,352,4440
Total (UTs),5 - Prohibition Act,2014,32,0,32,29,0,29,8,0,8,0,0,0,69,0,69
Total (UTs),6 - Explosives and Explosive Substances Act,2014,5,0,5,2,0,2,0,0,0,0,0,0,7,0,7
Total (UTs),"7 - Immoral Traffic (Prevention) Act, 1956",2014,35,46,81,26,16,42,3,0,3,2,1,3,66,63,129
Total (UTs),7.1 - Under Section 5,2014,31,42,73,19,9,28,3,0,3,2,1,3,55,52,107
Total (UTs),7.2 - Under Section 6,2014,0,0,0,2,4,6,0,0,0,0,0,0,2,4,6
Total (UTs),7.3 - Under Section 7,2014,0,0,0,0,0,0,0,0,0,0,0,0,0,0,0
Total (UTs),7.4 - Under Section 8,2014,0,0,0,1,0,1,0,0,0,0,0,0,1,0,1
Total (UTs),7.5 - Other Sections under ITP Act,2014,4,4,8,4,3,7,0,0,0,0,0,0,8,7,15
Total (UTs),"8 - Indian Railways Act, 1989",2014,0,0,0,0,0,0,0,0,0,0,0,0,0,0,0
Total (UTs),"9 - Registration of Foreigners Act, 1939",2014,0,0,0,1,0,1,0,0,0,0,0,0,1,0,1
Total (UTs),"10 - Protection of Civil Rights Act, 1955",2014,0,0,0,5,0,5,0,0,0,0,0,0,5,0,5
Total (UTs),10.1 - PCR Act for crimes committed against SCs,2014,0,0,0,5,0,5,0,0,0,0,0,0,5,0,5
Total (UTs),10.2 - PCR Act for crimes committed against STs,2014,0,0,0,0,0,0,0,0,0,0,0,0,0,0,0
Total (UTs),10.3 - PCR Act for crimes committed against Others,2014,0,0,0,0,0,0,0,0,0,0,0,0,0,0,0
Total (UTs),"11 - Passport Act, 1967",2014,0,0,0,1,0,1,0,0,0,0,0,0,1,0,1
Total (UTs),"12 - Essential Commodities Act, 1955",2014,41,0,41,55,1,56,13,0,13,0,0,0,109,1,110
Total (UTs),"13 - Antiquities & Art Treasures Act, 1972",2014,0,0,0,2,0,2,0,0,0,0,0,0,2,0,2
Total (UTs),"14 - Dowry Prohibition Act, 1961",2014,7,0,7,5,0,5,0,0,0,0,0,0,12,0,12
Total (UTs),"15 - Indecent Representation of Women (Prohibition) Act, 1986",2014,0,0,0,0,0,0,0,0,0,0,0,0,0,0,0
Total (UTs),"16 - Copyright Act, 1957",2014,18,1,19,116,0,116,17,0,17,3,0,3,154,1,155
Total (UTs),17 - Commission of Sati Prevention Act 1987,2014,0,0,0,0,0,0,0,0,0,0,0,0,0,0,0
Total (UTs),"18 - SC/ST (Prevention of Atrocities) Act, 1989)",2014,22,1,23,30,1,31,11,0,11,0,0,0,63,2,65
Total (UTs),18.1 - POA Act for crimes committed against SCs,2014,21,1,22,27,1,28,11,0,11,0,0,0,59,2,61
Total (UTs),18.2 - POA Act for crimes committed against STs,2014,1,0,1,3,0,3,0,0,0,0,0,0,4,0,4
Total (UTs),"19 - Forest Act, 1927",2014,4,0,4,18,0,18,10,0,10,0,0,0,32,0,32
Total (UTs),"20 - Prohibition of Child Marriage Act, 2006",2014,2,0,2,4,4,8,1,0,1,0,0,0,7,4,11
Total (UTs),"21 - Protection of Women from Domestic Violence Act, 2005",2014,0,0,0,0,0,0,0,0,0,0,0,0,0,0,0
Total (UTs),"22 - Information Technology Act, 2000",2014,23,0,23,26,0,26,5,0,5,0,0,0,54,0,54
Total (UTs),"23 - Official Secrets Act, 1923",2014,0,0,0,0,0,0,0,0,0,0,0,0,0,0,0
Total (UTs),"24 - Electricity Act, 2003",2014,58,0,58,175,2,177,60,0,60,2,0,2,295,2,297
Total (UTs),"25 - Wildlife Protection Act, 1972",2014,0,0,0,9,0,9,1,0,1,0,0,0,10,0,10
Total (UTs),"26 - Bonded Labour System (Abolition) Act, 1976",2014,0,0,0,1,0,1,0,0,0,0,0,0,1,0,1
Total (UTs),26.1 - Against SCs,2014,0,0,0,0,0,0,0,0,0,0,0,0,0,0,0
Total (UTs),26.2 - Against STs,2014,0,0,0,0,0,0,0,0,0,0,0,0,0,0,0
Total (UTs),26.3 - Against others,2014,0,0,0,1,0,1,0,0,0,0,0,0,1,0,1
Total (UTs),"27 - Environmental (Protection) Act, 1986",2014,0,0,0,0,0,0,0,0,0,0,0,0,0,0,0
Total (UTs),"28 - Air (Prevention & Control of Pollution) Act, 1981",2014,0,0,0,0,0,0,0,0,0,0,0,0,0,0,0
Total (UTs),"29 - Water (Prevention & Control of Pollution) Act, 1974(as amended in 1988)",2014,0,0,0,0,0,0,0,0,0,0,0,0,0,0,0
Total (UTs),"30 - National Security Act, 1980",2014,0,0,0,0,0,0,0,0,0,0,0,0,0,0,0
Total (UTs),"31 - Unlawful Activities (Prevention) Act, 1967",2014,1,0,1,0,0,0,0,0,0,0,0,0,1,0,1
Total (UTs),"32 - Young Persons (Harmful Publications) Act, 1956",2014,0,0,0,0,0,0,0,0,0,0,0,0,0,0,0
Total (UTs),"33 - Railway Property (Unlawful Possession) Act, 1966",2014,0,0,0,0,0,0,0,0,0,0,0,0,0,0,0
Total (UTs),"34 - Prevention of Damage to Public Property Act, 1984",2014,5,0,5,6,0,6,3,0,3,0,0,0,14,0,14
Total (UTs),"35 - Transplantation of Human Organs Act, 1994",2014,0,0,0,0,0,0,0,0,0,0,0,0,0,0,0
Total (UTs),"36 - Trade Marks Act, 1999",2014,3,0,3,14,0,14,15,4,19,4,0,4,36,4,40
Total (UTs),"37 - Prevention of Insults to National Honour Act, 1971",2014,0,0,0,0,0,0,0,0,0,0,0,0,0,0,0
Total (UTs),"38 - State Emblem (Prohibition of Improper Use) Act, 2005",2014,0,0,0,0,0,0,0,0,0,0,0,0,0,0,0
Total (UTs),"39 - Lotteries (Regulation) Act, 1998",2014,2,0,2,8,0,8,7,0,7,1,0,1,18,0,18
Total (UTs),"40 - Citizenship Act, 1955",2014,0,0,0,0,0,0,0,0,0,0,0,0,0,0,0
Total (UTs),"41 - Foreigners Act, 1946",2014,2,0,2,6,0,6,0,0,0,0,0,0,8,0,8
Total (UTs),"42 - Place of Worship (Special Provisions) Act, 1991",2014,0,0,0,0,0,0,0,0,0,0,0,0,0,0,0
Total (UTs),"43 - Religious Institution (Prevention of Misuse) Act, 1988",2014,0,0,0,0,0,0,0,0,0,0,0,0,0,0,0
Total (UTs),"44 - Representation of People Act, 1951",2014,1,0,1,6,0,6,5,0,5,0,0,0,12,0,12
Total (UTs),"45 - Emigration Act, 1983",2014,0,0,0,0,0,0,0,0,0,0,0,0,0,0,0
Total (UTs),"46 - Juvenile Justice (Care and Protection of Children) Act, 2000",2014,15,1,16,70,4,74,21,3,24,0,0,0,106,8,114
Total (UTs),"47 - Infant Substitutes Regulation Act, 2003",2014,0,0,0,0,0,0,0,0,0,0,0,0,0,0,0
Total (UTs),"48 - Anti-Hijacking Act, 1982",2014,0,0,0,0,0,0,0,0,0,0,0,0,0,0,0
Total (UTs),"49 - Atomic Energy Act, 1962",2014,0,0,0,0,0,0,0,0,0,0,0,0,0,0,0
Total (UTs),"50 - Weapons of Mass Destruction (Proh. of Unlawful Activities) Act, 2005",2014,0,0,0,0,0,0,0,0,0,0,0,0,0,0,0
Total (UTs),"51 - Suppression of Unlawful Acts against Safety of Civil Aviation Act, 1982",2014,0,0,0,0,0,0,0,0,0,0,0,0,0,0,0
Total (UTs),"52 - Safety of Maritime Navigation Act, 2002",2014,0,0,0,0,0,0,0,0,0,0,0,0,0,0,0
Total (UTs),"53 - Manual Scavengers and Construction of Dry Latrines (P) Act, 1993",2014,0,0,0,0,0,0,0,0,0,0,0,0,0,0,0
Total (UTs),"54 - Pre-Natal Diagnostic Techniques (Reg and Prev of Misuse) Act, 1994",2014,0,0,0,0,0,0,0,0,0,0,0,0,0,0,0
Total (UTs),"55 - The Maritime Zones of India (Reg of Fishing by Foreign Vessels) Act, 1981",2014,2,0,2,8,0,8,12,0,12,1,0,1,23,0,23
Total (UTs),56 - Other SLL crimes,2014,1721,10,1731,1423,27,1450,304,9,313,19,0,19,3467,46,3513
Total (UTs),57 - Total Cognizable SLL crimes,2014,5851,116,5967,5452,245,5697,1722,127,1849,244,32,276,13269,520,13789
Total (All India),"1 - Arms Act, 1959",2014,35771,14,35785,21744,21,21765,4720,3,4723,220,0,220,62455,38,62493
Total (All India),"2 - Narcotic Drugs & Psychotropic Substances Act, 1985",2014,28150,410,28560,19956,758,20714,5972,338,6310,344,34,378,54422,1540,55962
Total (All India),"3 - Gambling Act, 1867",2014,147744,192,147936,147571,493,148064,63367,204,63571,5474,17,5491,364156,906,365062
Total (All India),"4 - Excise Act, 1944",2014,78733,2005,80738,78424,3952,82376,31195,1773,32968,2174,154,2328,190526,7884,198410
Total (All India),5 - Prohibition Act,2014,131615,24621,156236,174599,48995,223594,79491,29148,108639,7921,1727,9648,393626,104491,498117
Total (All India),6 - Explosives and Explosive Substances Act,2014,1955,8,1963,2446,17,2463,760,2,762,50,0,50,5211,27,5238
Total (All India),"7 - Immoral Traffic (Prevention) Act, 1956",2014,2289,1099,3388,2218,910,3128,551,197,748,29,14,43,5087,2220,7307
Total (All India),7.1 - Under Section 5,2014,883,385,1268,748,309,1057,164,62,226,13,3,16,1808,759,2567
Total (All India),7.2 - Under Section 6,2014,119,81,200,131,44,175,37,8,45,4,0,4,291,133,424
Total (All India),7.3 - Under Section 7,2014,99,41,140,118,44,162,46,12,58,1,1,2,264,98,362
Total (All India),7.4 - Under Section 8,2014,34,48,82,68,81,149,10,12,22,0,1,1,112,142,254
Total (All India),7.5 - Other Sections under ITP Act,2014,1154,544,1698,1153,432,1585,294,103,397,11,9,20,2612,1088,3700
Total (All India),"8 - Indian Railways Act, 1989",2014,84,0,84,142,0,142,28,0,28,0,0,0,254,0,254
Total (All India),"9 - Registration of Foreigners Act, 1939",2014,421,36,457,283,17,300,108,5,113,3,0,3,815,58,873
Total (All India),"10 - Protection of Civil Rights Act, 1955",2014,59,3,62,83,0,83,26,4,30,5,0,5,173,7,180
Total (All India),10.1 - PCR Act for crimes committed against SCs,2014,57,3,60,71,0,71,26,4,30,5,0,5,159,7,166
Total (All India),10.2 - PCR Act for crimes committed against STs,2014,1,0,1,0,0,0,0,0,0,0,0,0,1,0,1
Total (All India),10.3 - PCR Act for crimes committed against Others,2014,1,0,1,12,0,12,0,0,0,0,0,0,13,0,13
Total (All India),"11 - Passport Act, 1967",2014,433,32,465,608,61,669,170,3,173,5,1,6,1216,97,1313
Total (All India),"12 - Essential Commodities Act, 1955",2014,2474,10,2484,4116,38,4154,1294,12,1306,88,2,90,7972,62,8034
Total (All India),"13 - Antiquities & Art Treasures Act, 1972",2014,18,0,18,47,0,47,25,0,25,1,0,1,91,0,91
Total (All India),"14 - Dowry Prohibition Act, 1961",2014,6347,1037,7384,7200,1832,9032,3478,1305,4783,252,80,332,17277,4254,21531
Total (All India),"15 - Indecent Representation of Women (Prohibition) Act, 1986",2014,24,0,24,38,1,39,5,0,5,0,0,0,67,1,68
Total (All India),"16 - Copyright Act, 1957",2014,2884,4,2888,3389,10,3399,671,0,671,14,0,14,6958,14,6972
Total (All India),17 - Commission of Sati Prevention Act 1987,2014,0,0,0,0,0,0,0,0,0,0,0,0,0,0,0
Total (All India),"18 - SC/ST (Prevention of Atrocities) Act, 1989)",2014,7903,152,8055,7654,350,8004,3175,135,3310,239,15,254,18971,652,19623
Total (All India),18.1 - POA Act for crimes committed against SCs,2014,7068,131,7199,6699,279,6978,2833,119,2952,179,12,191,16779,541,17320
Total (All India),18.2 - POA Act for crimes committed against STs,2014,835,21,856,955,71,1026,342,16,358,60,3,63,2192,111,2303
Total (All India),"19 - Forest Act, 1927",2014,2483,2,2485,3340,0,3340,1167,1,1168,41,0,41,7031,3,7034
Total (All India),"20 - Prohibition of Child Marriage Act, 2006",2014,168,10,178,280,92,372,105,40,145,11,5,16,564,147,711
Total (All India),"21 - Protection of Women from Domestic Violence Act, 2005",2014,204,21,225,277,30,307,130,17,147,14,0,14,625,68,693
Total (All India),"22 - Information Technology Act, 2000",2014,2285,27,2312,1595,26,1621,272,7,279,4,0,4,4156,60,4216
Total (All India),"23 - Official Secrets Act, 1923",2014,3,0,3,7,0,7,3,0,3,0,0,0,13,0,13
Total (All India),"24 - Electricity Act, 2003",2014,11885,42,11927,23488,94,23582,12538,69,12607,957,1,958,48868,206,49074
Total (All India),"25 - Wildlife Protection Act, 1972",2014,473,3,476,685,7,692,169,4,173,6,0,6,1333,14,1347
Total (All India),"26 - Bonded Labour System (Abolition) Act, 1976",2014,42,0,42,54,0,54,17,0,17,0,0,0,113,0,113
Total (All India),26.1 - Against SCs,2014,0,0,0,7,0,7,1,0,1,0,0,0,8,0,8
Total (All India),26.2 - Against STs,2014,0,0,0,0,0,0,0,0,0,0,0,0,0,0,0
Total (All India),26.3 - Against others,2014,42,0,42,47,0,47,16,0,16,0,0,0,105,0,105
Total (All India),"27 - Environmental (Protection) Act, 1986",2014,35,0,35,60,1,61,33,0,33,0,0,0,128,1,129
Total (All India),"28 - Air (Prevention & Control of Pollution) Act, 1981",2014,34,0,34,56,0,56,27,0,27,6,0,6,123,0,123
Total (All India),"29 - Water (Prevention & Control of Pollution) Act, 1974(as amended in 1988)",2014,16,0,16,18,0,18,4,0,4,0,0,0,38,0,38
Total (All India),"30 - National Security Act, 1980",2014,161,0,161,165,0,165,13,0,13,0,0,0,339,0,339
Total (All India),"31 - Unlawful Activities (Prevention) Act, 1967",2014,1047,23,1070,898,32,930,150,10,160,16,1,17,2111,66,2177
Total (All India),"32 - Young Persons (Harmful Publications) Act, 1956",2014,2,0,2,10,0,10,1,0,1,0,0,0,13,0,13
Total (All India),"33 - Railway Property (Unlawful Possession) Act, 1966",2014,1,0,1,0,0,0,0,0,0,0,0,0,1,0,1
Total (All India),"34 - Prevention of Damage to Public Property Act, 1984",2014,2513,12,2525,2600,35,2635,791,7,798,27,2,29,5931,56,5987
Total (All India),"35 - Transplantation of Human Organs Act, 1994",2014,0,0,0,0,0,0,0,0,0,0,0,0,0,0,0
Total (All India),"36 - Trade Marks Act, 1999",2014,32,0,32,62,0,62,28,4,32,4,0,4,126,4,130
Total (All India),"37 - Prevention of Insults to National Honour Act, 1971",2014,16,0,16,58,3,61,12,1,13,0,0,0,86,4,90
Total (All India),"38 - State Emblem (Prohibition of Improper Use) Act, 2005",2014,0,0,0,1,0,1,0,0,0,0,0,0,1,0,1
Total (All India),"39 - Lotteries (Regulation) Act, 1998",2014,777,0,777,1235,7,1242,449,1,450,36,0,36,2497,8,2505
Total (All India),"40 - Citizenship Act, 1955",2014,8,0,8,6,0,6,3,0,3,0,0,0,17,0,17
Total (All India),"41 - Foreigners Act, 1946",2014,1447,95,1542,1558,57,1615,496,51,547,3,0,3,3504,203,3707
Total (All India),"42 - Place of Worship (Special Provisions) Act, 1991",2014,6,0,6,2,0,2,0,0,0,0,0,0,8,0,8
Total (All India),"43 - Religious Institution (Prevention of Misuse) Act, 1988",2014,0,0,0,1,0,1,1,0,1,0,0,0,2,0,2
Total (All India),"44 - Representation of People Act, 1951",2014,211,2,213,398,4,402,174,0,174,11,0,11,794,6,800
Total (All India),"45 - Emigration Act, 1983",2014,14,0,14,33,3,36,8,0,8,0,0,0,55,3,58
Total (All India),"46 - Juvenile Justice (Care and Protection of Children) Act, 2000",2014,277,13,290,439,33,472,168,25,193,12,1,13,896,72,968
Total (All India),"47 - Infant Substitutes Regulation Act, 2003",2014,0,0,0,0,0,0,0,0,0,0,0,0,0,0,0
Total (All India),"48 - Anti-Hijacking Act, 1982",2014,0,0,0,0,0,0,0,0,0,0,0,0,0,0,0
Total (All India),"49 - Atomic Energy Act, 1962",2014,1,0,1,0,0,0,0,0,0,0,0,0,1,0,1
Total (All India),"50 - Weapons of Mass Destruction (Proh. of Unlawful Activities) Act, 2005",2014,0,0,0,0,0,0,0,0,0,0,0,0,0,0,0
Total (All India),"51 - Suppression of Unlawful Acts against Safety of Civil Aviation Act, 1982",2014,0,0,0,0,0,0,0,0,0,0,0,0,0,0,0
Total (All India),"52 - Safety of Maritime Navigation Act, 2002",2014,0,0,0,0,0,0,0,0,0,0,0,0,0,0,0
Total (All India),"53 - Manual Scavengers and Construction of Dry Latrines (P) Act, 1993",2014,0,0,0,0,0,0,0,0,0,0,0,0,0,0,0
Total (All India),"54 - Pre-Natal Diagnostic Techniques (Reg and Prev of Misuse) Act, 1994",2014,7,0,7,21,3,24,2,1,3,1,1,2,31,5,36
Total (All India),"55 - The Maritime Zones of India (Reg of Fishing by Foreign Vessels) Act, 1981",2014,17,0,17,42,0,42,19,0,19,1,0,1,79,0,79
Total (All India),56 - Other SLL crimes,2014,2025143,9117,2034260,1101707,7961,1109668,303721,2775,306496,16163,193,16356,3446734,20046,3466780
Total (All India),57 - Total Cognizable SLL crimes,2014,2496212,38990,2535202,1609614,65843,1675457,515537,36142,551679,34132,2248,36380,4655495,143223,4798718
